"Protein-Complexes"	"Genes of polypeptide, complex, or RNA"	"Components of a complex"
"1,4-dihydroxy-2-naphthoyl-CoA hydrolase"	"menI"	"1,4-dihydroxy-2-naphthoyl-CoA hydrolase"
"1,4-dihydroxy-2-naphthoyl-CoA synthase"	"menB"	"1,4-dihydroxy-2-naphthoyl-CoA synthase"
"1-deoxy-D-xylulose 5-phosphate reductoisomerase"	"dxr"	"1-deoxy-D-xylulose 5-phosphate reductoisomerase"
"1-deoxy-D-xylulose-5-phosphate synthase"	"dxs"	"1-deoxy-D-xylulose-5-phosphate synthase"
"1-hydroxy-2-methyl-2-(E)-butenyl 4-diphosphate reductase"	"ispH"	"1-hydroxy-2-methyl-2-(E)-butenyl 4-diphosphate reductase"
"1-phosphofructokinase"	"fruK"	"1-phosphofructokinase"
"16S rRNA 2'-<i>O</i>-ribose C1402 methyltransferase"	"rsmI"	"16S rRNA 2'-<i>O</i>-ribose C1402 methyltransferase"
"16S rRNA m<sup>3</sup>U1498 methyltransferase"	"rsmE"	"16S rRNA m<sup>3</sup>U1498 methyltransferase"
"16S rRNA m<sup>4</sup>C1402 methyltransferase"	"rsmH"	"16S rRNA m<sup>4</sup>C1402 methyltransferase"
"2,3-bisphosphoglycerate-dependent phosphoglycerate mutase"	"gpmA"	"2,3-bisphosphoglycerate-dependent phosphoglycerate mutase"
"2,3-diaminopropionate ammonia-lyase"	"ygeX"	"2,3-diaminopropionate ammonia-lyase"
"2,3-dihydro-2,3-dihydroxybenzoate dehydrogenase"	"entA"	"2,3-dihydro-2,3-dihydroxybenzoate dehydrogenase"
"2,3-dihydroxybenzoate-AMP ligase"	"entE"	"2,3-dihydroxybenzoate-AMP ligase"
"2,3-diketo-L-gulonate reductase"	"yiaK"	"2,3-diketo-L-gulonate reductase"
"2,3-diketo-L-gulonate:Na<sup>+</sup> symporter - periplasmic binding protein" // "2,3-diketo-L-gulonate:Na<sup>+</sup> symporter - membrane subunit" // "2,3-diketo-L-gulonate:Na<sup>+</sup> symporter - membrane subunit"	"yiaO" // "yiaN" // "yiaM"	"2,3-diketo-L-gulonate:Na<sup>+</sup> symporter - periplasmic binding protein" // "2,3-diketo-L-gulonate:Na<sup>+</sup> symporter - membrane subunit" // "2,3-diketo-L-gulonate:Na<sup>+</sup> symporter - membrane subunit"
"2-amino-3-ketobutyrate CoA ligase"	"kbl"	"2-amino-3-ketobutyrate CoA ligase"
"2-amino-6-<i>N</i>-hydroxylaminopurine resistance protein"	"yiiM"	"2-amino-6-<i>N</i>-hydroxylaminopurine resistance protein"
"2-<i>C</i>-methyl-D-erythritol 2,4-cyclodiphosphate synthase"	"ispF"	"2-<i>C</i>-methyl-D-erythritol 2,4-cyclodiphosphate synthase"
"2-<i>C</i>-methyl-D-erythritol 4-phosphate cytidylyltransferase"	"ispD"	"2-<i>C</i>-methyl-D-erythritol 4-phosphate cytidylyltransferase"
"2-hydroxy-6-ketonona-2,4-dienedioate hydrolase"	"mhpC"	"2-hydroxy-6-ketonona-2,4-dienedioate hydrolase"
"2-hydroxycyclohepta-1,4,6-triene-1-carboxyl-CoA thioesterase"	"paaY"	"2-hydroxycyclohepta-1,4,6-triene-1-carboxyl-CoA thioesterase"
"2-hydroxypentadienoate hydratase"	"mhpD"	"2-hydroxypentadienoate hydratase"
"2-keto-3-deoxy-L-rhamnonate aldolase"	"yfaU"	"2-keto-3-deoxy-L-rhamnonate aldolase"
"2-methylcitrate synthase"	"prpC"	"2-methylcitrate synthase"
"2-methylisocitrate lyase"	"prpB"	"2-methylisocitrate lyase"
"2-oxoglutarate dehydrogenase complex"	"sucA" // "sucB" // "lpd"	"subunit of E1(0) component of 2-oxoglutarate dehydrogenase" // "dihydrolipoyltranssuccinylase" // "lipoamide dehydrogenase"
"2-succinyl-5-enolpyruvyl-6-hydroxy-3-cyclohexene-1-carboxylate synthase"	"menD"	"2-succinyl-5-enolpyruvyl-6-hydroxy-3-cyclohexene-1-carboxylate synthase"
"23S rRNA 2'-<i>O</i>-ribose G2251 methyltransferase"	"rlmB"	"23S rRNA 2'-<i>O</i>-ribose G2251 methyltransferase"
"23S rRNA m<sup>3</sup>&Psi;1915 methyltransferase"	"rlmH"	"23S rRNA m<sup>3</sup>&Psi;1915 methyltransferase"
"23S rRNA m<sup>5</sup>C1962 methyltransferase"	"rlmI"	"23S rRNA m<sup>5</sup>C1962 methyltransferase"
"3,4-dihydroxy-2-butanone-4-phosphate synthase"	"ribB"	"3,4-dihydroxy-2-butanone-4-phosphate synthase"
"3-carboxyethylcatechol 2,3-dioxygenase"	"mhpB"	"3-carboxyethylcatechol 2,3-dioxygenase"
"3-dehydroquinate dehydratase"	"aroD"	"3-dehydroquinate dehydratase"
"3-deoxy-7-phosphoheptulonate synthase, Phe-sensitive"	"aroG"	"3-deoxy-7-phosphoheptulonate synthase, Phe-sensitive"
"3-deoxy-7-phosphoheptulonate synthase, Trp-sensitive"	"aroH"	"3-deoxy-7-phosphoheptulonate synthase, Trp-sensitive"
"3-deoxy-7-phosphoheptulonate synthase, Tyr-sensitive"	"aroF"	"3-deoxy-7-phosphoheptulonate synthase, Tyr-sensitive"
"3-deoxy-D-<i>manno</i>-octulosonate 8-phosphate phosphatase KdsC"	"kdsC"	"3-deoxy-D-<i>manno</i>-octulosonate 8-phosphate phosphatase KdsC"
"3-deoxy-D-<i>manno</i>-octulosonate 8-phosphate synthase"	"kdsA"	"3-deoxy-D-<i>manno</i>-octulosonate 8-phosphate synthase"
"3-hydroxy acid dehydrogenase"	"ydfG"	"3-hydroxy acid dehydrogenase"
"3-hydroxy-2,4-pentadione 5-phosphate thiolase"	"lsrF"	"3-hydroxy-2,4-pentadione 5-phosphate thiolase"
"3-hydroxy-acyl-[acyl-carrier-protein] dehydratase"	"fabZ"	"3-hydroxy-acyl-[acyl-carrier-protein] dehydratase"
"3-isopropylmalate dehydratase"	"leuC" // "leuD"	"3-isopropylmalate dehydratase subunit LeuC" // "3-isopropylmalate dehydratase subunit LeuD"
"3-isopropylmalate dehydrogenase"	"leuB"	"3-isopropylmalate dehydrogenase"
"3-keto-L-gulonate-6-phosphate decarboxylase UlaD"	"ulaD"	"3-keto-L-gulonate-6-phosphate decarboxylase UlaD"
"3-ketoacyl-CoA thiolase"	"fadA"	"3-ketoacyl-CoA thiolase"
"3-methyl-2-oxobutanoate hydroxymethyltransferase"	"panB"	"3-methyl-2-oxobutanoate hydroxymethyltransferase"
"3-octaprenyl-4-hydroxybenzoate decarboxylase"	"ubiD"	"3-octaprenyl-4-hydroxybenzoate decarboxylase"
"3-oxoacyl-[acyl-carrier-protein] reductase FabG"	"fabG"	"3-oxoacyl-[acyl-carrier-protein] reductase FabG"
"3-sulfolactaldehyde reductase"	"yihU"	"3-sulfolactaldehyde reductase"
"4-(cytidine 5'-diphospho)-2-<i>C</i>-methyl-D-erythritol kinase"	"ispE"	"4-(cytidine 5'-diphospho)-2-<i>C</i>-methyl-D-erythritol kinase"
"aminodeoxychorismate synthase subunit 1" // "aminodeoxychorismate synthase subunit 2"	"pabB" // "pabA"	"aminodeoxychorismate synthase subunit 1" // "aminodeoxychorismate synthase subunit 2"
"4-aminobutyrate aminotransferase GabT"	"gabT"	"4-aminobutyrate aminotransferase GabT"
"4-hydroxy-tetrahydrodipicolinate reductase"	"dapB"	"4-hydroxy-tetrahydrodipicolinate reductase"
"4-hydroxy-tetrahydrodipicolinate synthase"	"dapA"	"4-hydroxy-tetrahydrodipicolinate synthase"
"4-hydroxythreonine-4-phosphate dehydrogenase"	"pdxA"	"4-hydroxythreonine-4-phosphate dehydrogenase"
"5'-methylthioadenosine/S-adenosylhomocysteine nucleosidase"	"mtn"	"5'-methylthioadenosine/S-adenosylhomocysteine nucleosidase"
"5,10-methylenetetrahydrofolate reductase"	"metF"	"5,10-methylenetetrahydrofolate reductase"
"5-(carboxyamino)imidazole ribonucleotide synthase"	"purK"	"5-(carboxyamino)imidazole ribonucleotide synthase"
"5-carboxymethylaminomethyluridine-tRNA synthase GTPase subunit"	"mnmE"	"5-carboxymethylaminomethyluridine-tRNA synthase GTPase subunit"
"5-carboxymethylaminomethyluridine-tRNA synthase subunit MnmG"	"mnmG"	"5-carboxymethylaminomethyluridine-tRNA synthase subunit MnmG"
"5-carboxymethylaminomethyluridine-tRNA synthase GTPase subunit" // "5-carboxymethylaminomethyluridine-tRNA synthase subunit MnmG"	"mnmE" // "mnmG"	"5-carboxymethylaminomethyluridine-tRNA synthase GTPase subunit" // "5-carboxymethylaminomethyluridine-tRNA synthase subunit MnmG"
"5-dehydro-4-deoxy-D-glucuronate isomerase"	"kduI"	"5-dehydro-4-deoxy-D-glucuronate isomerase"
"5-oxoprolinase"	"pxpC" // "pxpB" // "pxpA"	"5-oxoprolinase component C" // "5-oxoprolinase component B" // "5-oxoprolinase component A"
"5-phospho-&alpha;-D-ribosyl 1,2-cyclic phosphate phosphodiesterase"	"phnP"	"5-phospho-&alpha;-D-ribosyl 1,2-cyclic phosphate phosphodiesterase"
"50S ribosomal protein complex L8"	"rplJ" // "rplL"	"50S ribosomal subunit protein L10" // "50S ribosomal subunit protein L12"
"50S ribosomal subunit protein L12"	"rplL"	"50S ribosomal subunit protein L12"
"6,7-dimethyl-8-ribityllumazine synthase"	"ribE"	"6,7-dimethyl-8-ribityllumazine synthase"
"6-carboxy-5,6,7,8-tetrahydropterin synthase"	"queD"	"6-carboxy-5,6,7,8-tetrahydropterin synthase"
"6-phosphofructokinase I"	"pfkA"	"6-phosphofructokinase I"
"6-phosphofructokinase II"	"pfkB"	"6-phosphofructokinase II"
"6-phosphogluconate dehydrogenase, decarboxylating"	"gnd"	"6-phosphogluconate dehydrogenase, decarboxylating"
"7-&alpha;-hydroxysteroid dehydrogenase"	"hdhA"	"7-&alpha;-hydroxysteroid dehydrogenase"
"7-cyano-7-deazaguanine reductase"	"queF"	"7-cyano-7-deazaguanine reductase"
"8-amino-7-oxononanoate synthase"	"bioF"	"8-amino-7-oxononanoate synthase"
"acetate/glycolate:cation symporter"	"actP"	"acetate/glycolate:cation symporter"
"&beta; complex" // "&alpha; complex"	"atoA" // "atoD"	"acetyl-CoA:acetoacetyl-CoA transferase subunit &beta;" // "acetyl-CoA:acetoacetyl-CoA transferase subunit &alpha;"
"acetolactate synthase II subunit IlvG, N-terminal fragment (pseudogene)" // "acetolactate synthase II subunit IlvM"	"ilvG_1" // "ilvM"	"acetolactate synthase II subunit IlvG, N-terminal fragment (pseudogene)" // "acetolactate synthase II subunit IlvM"
"acetohydroxy acid synthase I subunit IlvB" // "acetohydroxy acid synthase I subunit IlvN"	"ilvB" // "ilvN"	"acetohydroxy acid synthase I subunit IlvB" // "acetohydroxy acid synthase I subunit IlvN"
"acetolactate synthase / acetohydroxybutanoate synthase, catalytic subunit" // "acetolactate synthase / acetohydroxybutanoate synthase, regulatory subunit"	"ilvI" // "ilvH"	"acetolactate synthase / acetohydroxybutanoate synthase, catalytic subunit" // "acetolactate synthase / acetohydroxybutanoate synthase, regulatory subunit"
"acetyl-CoA acetyltransferase"	"atoB"	"acetyl-CoA acetyltransferase"
"acetyl-CoA carboxylase complex"	"accD" // "accA" // "accC" // "accB"	"acetyl-CoA carboxyltransferase subunit &beta;" // "acetyl-CoA carboxyltransferase subunit &alpha;" // "biotin carboxylase" // "biotin carboxyl carrier protein"
"acetyl-CoA carboxyltransferase subunit &alpha;" // "acetyl-CoA carboxyltransferase subunit &beta;"	"accA" // "accD"	"acetyl-CoA carboxyltransferase subunit &alpha;" // "acetyl-CoA carboxyltransferase subunit &beta;"
"acetyl-CoA:acetoacetyl-CoA transferase subunit &alpha;"	"atoD"	"acetyl-CoA:acetoacetyl-CoA transferase subunit &alpha;"
"acetyl-CoA:acetoacetyl-CoA transferase subunit &beta;"	"atoA"	"acetyl-CoA:acetoacetyl-CoA transferase subunit &beta;"
"acetyl-CoA:oxalate CoA-transferase"	"yfdE"	"acetyl-CoA:oxalate CoA-transferase"
"acetylesterase"	"aes"	"acetylesterase"
"acetylglutamate kinase"	"argB"	"acetylglutamate kinase"
"acetylornithine deacetylase"	"argE"	"acetylornithine deacetylase"
"acid phosphatase / phosphotransferase"	"aphA"	"acid phosphatase / phosphotransferase"
"aconitate hydratase 1"	"acnA"	"aconitate hydratase 1"
"acrylyl-CoA reductase"	"yhdH"	"acrylyl-CoA reductase"
"acyl-CoA thioesterase II"	"tesB"	"acyl-CoA thioesterase II"
"adenine deaminase"	"adeD"	"adenine deaminase"
"adenine phosphoribosyltransferase"	"apt"	"adenine phosphoribosyltransferase"
"adenosylmethionine-8-amino-7-oxononanoate aminotransferase"	"bioA"	"adenosylmethionine-8-amino-7-oxononanoate aminotransferase"
"adenylosuccinate lyase"	"purB"	"adenylosuccinate lyase"
"adenylosuccinate synthetase"	"purA"	"adenylosuccinate synthetase"
"adenylyl-sulfate kinase"	"cysC"	"adenylyl-sulfate kinase"
"ADP-L-glycero-D-mannoheptose 6-epimerase"	"rfaD"	"ADP-L-glycero-D-mannoheptose 6-epimerase"
"ADP-sugar diphosphatase NudE"	"nudE"	"ADP-sugar diphosphatase NudE"
"ADP-sugar pyrophosphatase"	"nudF"	"ADP-sugar pyrophosphatase"
"aerobic fatty acid oxidation complex"	"fadB" // "fadA"	"dodecenoyl-CoA &delta;-isomerase, enoyl-CoA hydratase, 3-hydroxybutyryl-CoA epimerase, 3-hydroxyacyl-CoA dehydrogenase" // "3-ketoacyl-CoA thiolase"
"aerobic glycerol 3-phosphate dehydrogenase"	"glpD"	"aerobic glycerol 3-phosphate dehydrogenase"
"agmatinase"	"speB"	"agmatinase"
"alanine racemase 1"	"alr"	"alanine racemase 1"
"alanine racemase 2"	"dadX"	"alanine racemase 2"
"alanine&mdash;tRNA ligase/DNA-binding transcriptional repressor"	"alaS"	"alanine&mdash;tRNA ligase/DNA-binding transcriptional repressor"
"aldehyde dehydrogenase, Fe-S subunit" // "aldehyde dehydrogenase, FAD-binding subunit" // "aldehyde dehydrogenase: molybdenum cofactor-binding subunit"	"paoA" // "paoB" // "paoC"	"aldehyde dehydrogenase, Fe-S subunit" // "aldehyde dehydrogenase, FAD-binding subunit" // "aldehyde dehydrogenase: molybdenum cofactor-binding subunit"
"aldehyde dehydrogenase A"	"aldA"	"aldehyde dehydrogenase A"
"aldehyde dehydrogenase B"	"aldB"	"aldehyde dehydrogenase B"
"aldehyde-alcohol dehydrogenase"	"adhE"	"aldehyde-alcohol dehydrogenase"
"aliphatic sulfonate ABC transporter"	"ssuA" // "ssuC" // "ssuB"	"aliphatic sulfonate ABC transporter periplasmic binding protein" // "aliphatic sulfonate ABC transporter membrane subunit" // "aliphatic sulfonate ABC transporter ATP binding subunit"
"alkaline phosphatase"	"phoA"	"alkaline phosphatase"
"alkyl hydroperoxide reductase"	"ahpC" // "ahpF"	"alkyl hydroperoxide reductase, AhpC component" // "alkyl hydroperoxide reductase, AhpF component"
"<i>all-trans</i>-octaprenyl-diphosphate synthase"	"ispB"	"<i>all-trans</i>-octaprenyl-diphosphate synthase"
"allantoate amidohydrolase"	"allC"	"allantoate amidohydrolase"
"allantoinase"	"allB"	"allantoinase"
"allose-6-phosphate isomerase / ribose-5-phosphate isomerase B"	"rpiB"	"allose-6-phosphate isomerase / ribose-5-phosphate isomerase B"
"&alpha;-D-xyloside xylohydrolase"	"yicI"	"&alpha;-D-xyloside xylohydrolase"
"&alpha;-dehydro-&beta;-deoxy-<i>D</i>-glucarate aldolase"	"garL"	"&alpha;-dehydro-&beta;-deoxy-<i>D</i>-glucarate aldolase"
"&alpha;-galactosidase"	"melA"	"&alpha;-galactosidase"
"amidophosphoribosyltransferase"	"purF"	"amidophosphoribosyltransferase"
"amino acid racemase"	"ygeA"	"amino acid racemase"
"aminodeoxychorismate lyase"	"pabC"	"aminodeoxychorismate lyase"
"aminopeptidase A/I"	"pepA"	"aminopeptidase A/I"
"aminopeptidase B"	"pepB"	"aminopeptidase B"
"ammonia/ammonium transporter"	"amtB"	"ammonia/ammonium transporter"
"AMP nucleosidase"	"amn"	"AMP nucleosidase"
"anaerobic fatty acid &beta;-oxidation complex"	"fadI" // "fadJ"	"3-ketoacyl-CoA thiolase FadI" // "3-hydroxyacyl-CoA dehydrogenase FadJ"
"anaerobic glycerol-3-phosphate dehydrogenase"	"glpA" // "glpB" // "glpC"	"anaerobic glycerol-3-phosphate dehydrogenase subunit A" // "anaerobic glycerol-3-phosphate dehydrogenase subunit B" // "anaerobic glycerol-3-phosphate dehydrogenase subunit C"
"anaerobic nitric oxide reductase flavorubredoxin"	"norV"	"anaerobic nitric oxide reductase flavorubredoxin"
"anaerobic nucleoside-triphosphate reductase activating system"	"nrdD" // "nrdG"	"anaerobic ribonucleoside-triphosphate reductase" // "anaerobic ribonucleoside-triphosphate reductase activating protein"
"anaerobic ribonucleoside-triphosphate reductase"	"nrdD"	"anaerobic ribonucleoside-triphosphate reductase"
"anaerobic ribonucleoside-triphosphate reductase activating protein"	"nrdG"	"anaerobic ribonucleoside-triphosphate reductase activating protein"
"anthranilate synthase subunit TrpE" // "anthranilate synthase subunit TrpD"	"trpE" // "trpD"	"anthranilate synthase subunit TrpE" // "anthranilate synthase subunit TrpD"
"anti-sigma factor stabilizing protein RseB"	"rseB"	"anti-sigma factor stabilizing protein RseB"
"antitoxin of the MazF-MazE toxin-antitoxin system MazE"	"mazE"	"antitoxin of the MazF-MazE toxin-antitoxin system MazE"
"antitoxin/DNA-binding transcriptional repressor HigA"	"higA"	"antitoxin/DNA-binding transcriptional repressor HigA"
"antitoxin/DNA-binding transcriptional repressor HipB"	"hipB"	"antitoxin/DNA-binding transcriptional repressor HipB"
"arabinose ABC transporter"	"araG" // "araH" // "araF"	"arabinose ABC transporter ATP binding subunit" // "arabinose ABC transporter membrane subunit" // "arabinose ABC transporter periplasmic binding protein"
"arginine decarboxylase, biosynthetic"	"speA"	"arginine decarboxylase, biosynthetic"
"arginine decarboxylase, degradative"	"adiA"	"arginine decarboxylase, degradative"
"arginine:agmatine antiporter"	"adiC"	"arginine:agmatine antiporter"
"argininosuccinate synthetase"	"argG"	"argininosuccinate synthetase"
"aromatic carboxylic acid efflux pump"	"aaeA" // "aaeB"	"aromatic carboxylic acid efflux pump membrane fusion protein" // "aromatic carboxylic acid efflux pump subunit AaeB"
"arsenite/antimonite:H<sup>+</sup> antiporter"	"arsB"	"arsenite/antimonite:H<sup>+</sup> antiporter"
"arylamine <i>N</i>-acetyltransferase"	"nhoA"	"arylamine <i>N</i>-acetyltransferase"
"asparagine synthetase A"	"asnA"	"asparagine synthetase A"
"asparagine synthetase B"	"asnB"	"asparagine synthetase B"
"asparagine&mdash;tRNA ligase"	"asnS"	"asparagine&mdash;tRNA ligase"
"aspartate 1-decarboxylase"	"panD"	"aspartate 1-decarboxylase proenzyme" // "aspartate 1-decarboxylase proenzyme"
"aspartate aminotransferase"	"aspC"	"aspartate aminotransferase"
"aspartate ammonia-lyase"	"aspA"	"aspartate ammonia-lyase"
"aspartate carbamoyltransferase catalytic subunit" // "aspartate carbamoyltransferase, regulatory subunit"	"pyrB" // "pyrI"	"aspartate carbamoyltransferase catalytic subunit" // "aspartate carbamoyltransferase, PyrI subunit"
"aspartate carbamoyltransferase catalytic subunit"	"pyrB"	"aspartate carbamoyltransferase catalytic subunit"
"aspartate carbamoyltransferase, PyrI subunit"	"pyrI"	"aspartate carbamoyltransferase, PyrI subunit"
"aspartate kinase III"	"lysC"	"aspartate kinase III"
"aspartate&mdash;tRNA ligase"	"aspS"	"aspartate&mdash;tRNA ligase"
"aspartate-semialdehyde dehydrogenase"	"asd"	"aspartate-semialdehyde dehydrogenase"
"assimilatory sulfite reductase (NADPH)"	"cysJ" // "cysI"	"sulfite reductase, flavoprotein subunit" // "sulfite reductase, hemoprotein subunit"
"ATP dependent structure specific DNA nuclease"	"sbcC" // "sbcD"	"ATP dependent, structure specific DNA nuclease - SbcC subunit" // "ATP dependent, structure specific DNA nuclease - SbcD subunit"
"ATP phosphoribosyltransferase"	"hisG"	"ATP phosphoribosyltransferase"
"ATP synthase F<sub>o</sub> complex" // "ATP synthase F<sub>1</sub> complex"	"atpB" // "atpF" // "atpE" // "atpD" // "atpG" // "atpA" // "atpH" // "atpC"	"ATP synthase F<sub>o</sub> complex subunit a" // "ATP synthase F<sub>o</sub> complex subunit b" // "ATP synthase F<sub>o</sub> complex subunit c" // "ATP synthase F<sub>1</sub> complex subunit &beta;" // "ATP synthase F<sub>1</sub> complex subunit &gamma;" // "ATP synthase F<sub>1</sub> complex subunit &alpha;" // "ATP synthase F<sub>1</sub> complex subunit &delta;" // "ATP synthase F<sub>1</sub> complex subunit &epsilon;"
"ATP synthase F<sub>1</sub> complex"	"atpC" // "atpH" // "atpA" // "atpG" // "atpD"	"ATP synthase F<sub>1</sub> complex subunit &epsilon;" // "ATP synthase F<sub>1</sub> complex subunit &delta;" // "ATP synthase F<sub>1</sub> complex subunit &alpha;" // "ATP synthase F<sub>1</sub> complex subunit &gamma;" // "ATP synthase F<sub>1</sub> complex subunit &beta;"
"ATP synthase F<sub>1</sub> complex subunit &alpha;"	"atpA"	"ATP synthase F<sub>1</sub> complex subunit &alpha;"
"ATP synthase F<sub>1</sub> complex subunit &beta;"	"atpD"	"ATP synthase F<sub>1</sub> complex subunit &beta;"
"ATP synthase F<sub>o</sub> complex"	"atpE" // "atpF" // "atpB"	"ATP synthase F<sub>o</sub> complex subunit c" // "ATP synthase F<sub>o</sub> complex subunit b" // "ATP synthase F<sub>o</sub> complex subunit a"
"ATP synthase F<sub>o</sub> complex subunit b"	"atpF"	"ATP synthase F<sub>o</sub> complex subunit b"
"ATP synthase F<sub>o</sub> complex subunit c"	"atpE"	"ATP synthase F<sub>o</sub> complex subunit c"
"ATP-binding lipopolysaccharide transport protein"	"msbA"	"ATP-binding lipopolysaccharide transport protein"
"ATP-dependent Clp protease ATP-binding subunit ClpA"	"clpA"	"ATP-dependent Clp protease ATP-binding subunit ClpA"
"ATP-dependent Clp protease ATP-binding subunit ClpX"	"clpX"	"ATP-dependent Clp protease ATP-binding subunit ClpX"
"ATP-dependent Clp protease proteolytic subunit"	"clpP"	"ATP-dependent Clp protease proteolytic subunit"
"ATP-dependent DNA helicase Rep"	"rep"	"ATP-dependent DNA helicase Rep"
"ATP-independent periplasmic chaperone"	"spy"	"ATP-independent periplasmic chaperone"
"ATPase component of the HslVU protease"	"hslU"	"ATPase component of the HslVU protease"
"Autoinducer-2 ABC transporter periplasmic binding protein" // "Autoinducer-2 ABC transporter membrane subunit LsrD" // "Autoinducer-2 ABC transporter membrane subunit LsrC" // "Autoinducer-2 ABC transporter ATP binding subunit"	"lsrB" // "lsrD" // "lsrC" // "lsrA"	"Autoinducer-2 ABC transporter periplasmic binding protein" // "Autoinducer-2 ABC transporter membrane subunit LsrD" // "Autoinducer-2 ABC transporter membrane subunit LsrC" // "Autoinducer-2 ABC transporter ATP binding subunit"
"bacterial condensin MukBEF"	"mukB" // "mukF" // "mukE"	"chromosome partitioning protein MukB" // "chromosome partitioning protein MukF" // "chromosome partitioning protein MukE"
"bacterioferritin"	"bfr"	"bacterioferritin"
"&beta; sliding clamp"	"dnaN"	"&beta; sliding clamp"
"&beta;-galactosidase"	"lacZ"	"&beta;-galactosidase"
"&beta;-glucoside specific PTS enzyme II / BglG kinase / BglG phosphatase"	"bglF"	"&beta;-glucoside specific PTS enzyme II / BglG kinase / BglG phosphatase"
"&beta;-glucoside specific PTS enzyme IIBC component"	"ascF"	"&beta;-glucoside specific PTS enzyme IIBC component"
"&beta;-glucuronidase"	"uidA"	"&beta;-glucuronidase"
"&beta;-hydroxyacyl-acyl carrier protein dehydratase/isomerase"	"fabA"	"&beta;-hydroxyacyl-acyl carrier protein dehydratase/isomerase"
"&beta;-ketoacyl-[acyl carrier protein] synthase I"	"fabB"	"&beta;-ketoacyl-[acyl carrier protein] synthase I"
"&beta;-ketoacyl-[acyl carrier protein] synthase II"	"fabF"	"&beta;-ketoacyl-[acyl carrier protein] synthase II"
"&beta;-ketoacyl-[acyl carrier protein] synthase III"	"fabH"	"&beta;-ketoacyl-[acyl carrier protein] synthase III"
"betaine aldehyde dehydrogenase"	"betB"	"betaine aldehyde dehydrogenase"
"bifunctional 3-demethylubiquinone-<i>8</i> 3-<i>O</i>-methyltransferase and 2-octaprenyl-6-hydroxyphenol methylase"	"ubiG"	"bifunctional 3-demethylubiquinone-<i>8</i> 3-<i>O</i>-methyltransferase and 2-octaprenyl-6-hydroxyphenol methylase"
"bifunctional 5,10-methylene-tetrahydrofolate dehydrogenase/ 5,10-methylene-tetrahydrofolate cyclohydrolase"	"folD"	"bifunctional 5,10-methylene-tetrahydrofolate dehydrogenase/ 5,10-methylene-tetrahydrofolate cyclohydrolase"
"bifunctional aconitate hydratase B and 2-methylisocitrate dehydratase"	"acnB"	"bifunctional aconitate hydratase B and 2-methylisocitrate dehydratase"
"bifunctional hydroxymethylpyrimidine kinase/phosphomethylpyrimidine kinase"	"thiD"	"bifunctional hydroxymethylpyrimidine kinase/phosphomethylpyrimidine kinase"
"biotin carboxyl carrier protein (dimer)"	"accB"	"biotin carboxyl carrier protein"
"biotin carboxylase"	"accC"	"biotin carboxylase"
"biotin synthase"	"bioB"	"biotin synthase"
"branched chain amino acid / phenylalanine ABC transporter"	"livF" // "livG" // "livH" // "livM" // "livJ"	"branched chain amino acid/phenylalanine ABC transporter ATP binding subunit LivF" // "branched chain amino acid/phenylalanine ABC transporter ATP binding subunit LivG" // "branched chain amino acid/phenylalanine ABC transporter membrane subunit LivH" // "branched chain amino acid/phenylalanine ABC transporter membrane subunit LivM" // "branched chain amino acid/phenylalanine ABC transporter periplasmic binding protein"
"branched-chain-amino-acid aminotransferase"	"ilvE"	"branched-chain-amino-acid aminotransferase"
"c-di-GMP-binding biofilm dispersal mediator protein"	"bdcA"	"c-di-GMP-binding biofilm dispersal mediator protein"
"carbamoyl phosphate synthetase subunit &beta;" // "carbamoyl phosphate synthetase subunit &alpha;"	"carB" // "carA"	"carbamoyl phosphate synthetase subunit &beta;" // "carbamoyl phosphate synthetase subunit &alpha;"
"carbon storage regulator"	"csrA"	"carbon storage regulator"
"carbon-phosphorus lyase core complex"	"phnJ" // "phnI" // "phnH" // "phnG"	"carbon-phosphorus lyase core complex subunit PhnJ" // "carbon-phosphorus lyase core complex subunit PhnI" // "carbon-phosphorus lyase core complex subunit PhnH" // "carbon-phosphorus lyase core complex subunit PhnG"
"carbonic anhydrase 1"	"cynT"	"carbonic anhydrase 1"
"carbonic anhydrase 2"	"can"	"carbonic anhydrase 2"
"carboxy-<i>S</i>-adenosyl-L-methionine synthase"	"cmoA"	"carboxy-<i>S</i>-adenosyl-L-methionine synthase"
"carboxylate-amine ligase"	"ybdK"	"carboxylate-amine ligase"
"carboxylesterase"	"yjfP"	"carboxylesterase"
"carnitine monooxygenase"	"yeaX" // "yeaW"	"carnitine monooxygenase subunit YeaX" // "carnitine monooxygenase subunit YeaW"
"carnitine monooxygenase subunit YeaW"	"yeaW"	"carnitine monooxygenase subunit YeaW"
"Cas1-Cas2 complex"	"cas2" // "cas1"	"CRISPR-associated endoribonuclease Cas2" // "multifunctional nuclease Cas1"
"catabolic threonine dehydratase"	"tdcB"	"catabolic threonine dehydratase"
"catalase II"	"katE"	"catalase II"
"cell division factor ZapB"	"zapB"	"cell division factor ZapB"
"cell division factor ZapD"	"zapD"	"cell division factor ZapD"
"cell division protein ZapA"	"zapA"	"cell division protein ZapA"
"cellulose synthase"	"bcsB" // "bcsA"	"cellulose synthase periplasmic subunit" // "cellulose synthase catalytic subunit"
"chaperone protein DnaJ"	"dnaJ"	"chaperone protein DnaJ"
"chaperone protein HtpG"	"htpG"	"chaperone protein HtpG"
"chemotaxis protein CheA"	"cheA"	"chemotaxis protein CheA"
"chemotaxis protein CheZ"	"cheZ"	"chemotaxis protein CheZ"
"chemotaxis signaling complex - aspartate sensing"	"cheA" // "cheW" // "tar"	"chemotaxis protein CheA" // "chemotaxis protein CheW" // "methyl-accepting chemotaxis protein Tar"
"chemotaxis signaling complex - dipeptide sensing"	"cheA" // "cheW" // "tap"	"chemotaxis protein CheA" // "chemotaxis protein CheW" // "methyl-accepting chemotaxis protein Tap"
"chemotaxis signaling complex - ribose/galactose/glucose sensing"	"cheA" // "cheW" // "trg"	"chemotaxis protein CheA" // "chemotaxis protein CheW" // "methyl-accepting chemotaxis protein Trg"
"chemotaxis signaling complex - serine sensing"	"cheW" // "cheA" // "tsr"	"chemotaxis protein CheW" // "chemotaxis protein CheA" // "methyl-accepting chemotaxis protein Tsr"
"chloride:H<sup>+</sup> antiporter ClcA"	"clcA"	"chloride:H<sup>+</sup> antiporter ClcA"
"chorismate synthase"	"aroC"	"chorismate synthase"
"ChpB-ChpS complex"	"chpB" // "chpS"	"endoribonuclease toxin ChpB" // "ChpS antitoxin of the ChpB-ChpS toxin-antitoxin system"
"chromate reductase"	"yieF"	"chromate reductase"
"chromosome partitioning protein MukB"	"mukB"	"chromosome partitioning protein MukB"
"chromosome partitioning protein MukF"	"mukF"	"chromosome partitioning protein MukF"
"citrate lyase acyl carrier protein"	"citD"	"citrate lyase acyl carrier protein"
"citrate lyase &alpha; subunit"	"citF"	"citrate lyase &alpha; subunit"
"citrate lyase &beta; subunit"	"citE"	"citrate lyase &beta; subunit"
"citrate lyase, inactive"	"citD" // "citF" // "citE"	"citrate lyase acyl carrier protein" // "citrate lyase &alpha; subunit" // "citrate lyase &beta; subunit"
"citrate synthase"	"gltA"	"citrate synthase"
"ClpAP"	"clpP" // "clpA"	"ATP-dependent Clp protease proteolytic subunit" // "ATP-dependent Clp protease ATP-binding subunit ClpA"
"ClpAXP"	"clpP" // "clpA" // "clpX"	"ATP-dependent Clp protease proteolytic subunit" // "ATP-dependent Clp protease ATP-binding subunit ClpA" // "ATP-dependent Clp protease ATP-binding subunit ClpX"
"ClpB chaperone"	"clpB"	"ClpB chaperone"
"ClpXP"	"clpP" // "clpX"	"ATP-dependent Clp protease proteolytic subunit" // "ATP-dependent Clp protease ATP-binding subunit ClpX"
"ClpXP protease specificity-enhancing factor"	"sspB"	"ClpXP protease specificity-enhancing factor"
"cobinamide-P guanylyltransferase / cobinamide kinase"	"cobU"	"cobinamide-P guanylyltransferase / cobinamide kinase"
"Colicin E9 translocon"	"tolB" // "ompF"	"Tol-Pal system periplasmic protein TolB" // "outer membrane porin F"
"copper binding protein CutA"	"cutA"	"copper binding protein CutA"
"copper-containing amine oxidase"	"tynA"	"copper-containing amine oxidase"
"copper/silver export system"	"cusC" // "cusB" // "cusF" // "cusA"	"copper/silver export system outer membrane channel" // "copper/silver export system membrane fusion protein" // "copper/silver export system periplasmic binding protein" // "copper/silver export system RND permease"
"coproporphyrinogen III oxidase"	"hemF"	"coproporphyrinogen III oxidase"
"CP4-57 prophage; RNase LS, toxin of the RnlAB toxin-antitoxin system"	"rnlA"	"CP4-57 prophage; RNase LS, toxin of the RnlAB toxin-antitoxin system"
"CP4-6 prophage; putative 2-keto-3-deoxygluconate aldolase"	"yagE"	"CP4-6 prophage; putative 2-keto-3-deoxygluconate aldolase"
"CRISPR-associated complex for antiviral defense"	"casA" // "casB" // "casC" // "casD" // "casE"	"type I-E CRISPR system Cascade subunit CasA" // "type I-E CRISPR system Cascade subunit CasB" // "type I-E CRISPR system Cascade subunit CasC" // "type I-E CRISPR system Cascade subunit CasD" // "pre-CRISPR RNA endonuclease"
"CRISPR-associated endoribonuclease Cas2"	"cas2"	"CRISPR-associated endoribonuclease Cas2"
"cryptic phosphonate ABC transporter"	"phnC" // "phnE_1" // "phnD"	"cryptic phosphonate ABC transporter ATP binding subunit" // "cryptic phosphonate ABC transporter membrane subunit" // "cryptic phosphonate ABC transporter periplasmic binding protein"
"CTP synthase"	"pyrG"	"CTP synthase"
"curli transport specificity factor" // "curli secretion channel"	"csgE" // "csgG"	"curli transport specificity factor" // "curli secretion channel"
"curved DNA-binding protein"	"cbpA"	"curved DNA-binding protein"
"cyanase"	"cynS"	"cyanase"
"cyclic di-GMP phosphodiesterase PdeF"	"pdeF"	"cyclic di-GMP phosphodiesterase PdeF"
"cyclic pyranopterin monophosphate synthase"	"moaC"	"cyclic pyranopterin monophosphate synthase"
"cyclopropane fatty acyl phospholipid synthase"	"cfa"	"cyclopropane fatty acyl phospholipid synthase"
"cystathionine &beta;-lyase / L-cysteine desulfhydrase"	"metC"	"cystathionine &beta;-lyase / L-cysteine desulfhydrase"
"cysteine desulfurase"	"iscS"	"cysteine desulfurase"
"cysteine sulfinate desulfinase"	"csdA"	"cysteine sulfinate desulfinase"
"cysteine synthase B"	"cysM"	"cysteine synthase B"
"cysteine synthase complex"	"cysE" // "cysK"	"serine acetyltransferase" // "<i>O</i>-acetylserine sulfhydrylase A"
"cystine / cysteine ABC transporter"	"tcyN" // "tcyL" // "tcyJ"	"cystine/cysteine ABC transporter ATP binding subunit" // "cystine/cysteine ABC transporter membrane subunit" // "cystine/cysteine ABC transporter periplasmic binding protein"
"cytidine/deoxycytidine deaminase"	"cdd"	"cytidine/deoxycytidine deaminase"
"cytochrome <i>bd</i>-I ubiquinol oxidase subunit I" // "cytochrome <i>bd</i>-I ubiquinol oxidase subunit II" // "cytochrome <i>bd</i>-I ubiquinol oxidase subunit CydX"	"cydA" // "cydB" // "cydX"	"cytochrome <i>bd</i>-I ubiquinol oxidase subunit I" // "cytochrome <i>bd</i>-I ubiquinol oxidase subunit II" // "cytochrome <i>bd</i>-I ubiquinol oxidase subunit CydX"
"cytochrome <i>bd</i>-II ubiquinol oxidase"	"appC" // "appB"	"cytochrome <i>bd</i>-II ubiquinol oxidase subunit I" // "cytochrome <i>bd</i>-II ubiquinol oxidase subunit II"
"cytochrome <i>bo<sub>3</sub></i> ubiquinol oxidase"	"cyoD" // "cyoA" // "cyoB" // "cyoC"	"cytochrome <i>bo</i><sub>3</sub> ubiquinol oxidase subunit 4" // "cytochrome <i>bo</i><sub>3</sub> ubiquinol oxidase subunit 2" // "cytochrome <i>bo</i><sub>3</sub> ubiquinol oxidase subunit 1" // "cytochrome <i>bo</i><sub>3</sub> ubiquinol oxidase subunit 3"
"cytosine/isoguanine deaminase"	"codA"	"cytosine/isoguanine deaminase"
"D-alanine&mdash;D-alanine ligase B"	"ddlB"	"D-alanine&mdash;D-alanine ligase B"
"D-alanyl-D-alanine carboxypeptidase DacA"	"dacA"	"D-alanyl-D-alanine carboxypeptidase DacA"
"D-alanyl-D-alanine carboxypeptidase DacC"	"dacC"	"D-alanyl-D-alanine carboxypeptidase DacC"
"D-allose ABC transporter ATP binding subunit" // "D-allose ABC transporter membrane subunit" // "D-allose ABC transporter periplasmic binding protein"	"alsA" // "alsC" // "alsB"	"D-allose ABC transporter ATP binding subunit" // "D-allose ABC transporter membrane subunit" // "D-allose ABC transporter periplasmic binding protein"
"D-amino acid dehydrogenase"	"dadA"	"D-amino acid dehydrogenase"
"D-aminoacyl-tRNA deacylase"	"dtd"	"D-aminoacyl-tRNA deacylase"
"D-arabinose 5-phosphate isomerase GutQ"	"gutQ"	"D-arabinose 5-phosphate isomerase GutQ"
"D-arabinose 5-phosphate isomerase KdsD"	"kdsD"	"D-arabinose 5-phosphate isomerase KdsD"
"D-cysteine desulfhydrase"	"dcyD"	"D-cysteine desulfhydrase"
"D-erythrose-4-phosphate dehydrogenase"	"epd"	"D-erythrose-4-phosphate dehydrogenase"
"D-galactose / methyl-&beta;-D-galactoside ABC transporter"	"mglA" // "mglC" // "mglB"	"D-galactose/methyl-galactoside ABC transporter ATP binding subunit" // "D-galactose/methyl-galactoside ABC transporter membrane subunit" // "D-galactose/methyl-galactoside ABC transporter periplasmic binding protein"
"D-gluconate kinase, thermostable"	"gntK"	"D-gluconate kinase, thermostable"
"D-lactate dehydrogenase"	"ldhA"	"D-lactate dehydrogenase"
"D-ribose pyranase"	"rbsD"	"D-ribose pyranase"
"D-sedoheptulose 7-phosphate isomerase"	"lpcA"	"D-sedoheptulose 7-phosphate isomerase"
"dCMP phosphohydrolase"	"yfbR"	"dCMP phosphohydrolase"
"dCTP deaminase"	"dcd"	"dCTP deaminase"
"DcuR"	"dcuR"	"DNA-binding transcriptional activator DcuR"
"degradosome"	"ppk" // "rne" // "rhlB" // "pnp" // "eno"	"polyphosphate kinase" // "ribonuclease E" // "RhlB, ATP-dependent RNA helicase of the RNA degradosome" // "polynucleotide phosphorylase" // "enolase"
"deoxyuridine triphosphatase"	"dut"	"deoxyuridine triphosphatase"
"Der GTPase-activating protein YihI"	"yihI"	"Der GTPase-activating protein YihI"
"dethiobiotin synthetase"	"bioD"	"dethiobiotin synthetase"
"dGTP triphosphohydrolase"	"dgt"	"dGTP triphosphohydrolase"
"diacylglycerol kinase"	"dgkA"	"diacylglycerol kinase"
"diaminopimelate decarboxylase"	"lysA"	"diaminopimelate decarboxylase"
"diaminopimelate epimerase"	"dapF"	"diaminopimelate epimerase"
"diguanylate cyclase DgcM"	"dgcM"	"diguanylate cyclase DgcM"
"diguanylate cyclase DgcZ"	"dgcZ"	"diguanylate cyclase DgcZ"
"diguanylate cyclase DosC"	"dosC"	"diguanylate cyclase DosC"
"dihydrolipoyltranssuccinylase"	"sucB"	"dihydrolipoyltranssuccinylase"
"dihydroneopterin aldolase"	"folB"	"dihydroneopterin aldolase"
"dihydroneopterin triphosphate 2'-epimerase"	"folX"	"dihydroneopterin triphosphate 2'-epimerase"
"dihydroorotase"	"pyrC"	"dihydroorotase"
"dihydropteroate synthase"	"folP"	"dihydropteroate synthase"
"dihydroxy-acid dehydratase"	"ilvD"	"dihydroxy-acid dehydratase"
"dihydroxyacetone kinase"	"dhaK" // "dhaL" // "dhaM"	"dihydroxyacetone kinase subunit K" // "dihydroxyacetone kinase subunit L" // "dihydroxyacetone kinase subunit M/protein-lysine deacetylase"
"dihydroxyacetone kinase subunit M/protein-lysine deacetylase"	"dhaM"	"dihydroxyacetone kinase subunit M/protein-lysine deacetylase"
"dimethyl sulfoxide reductase subunit A" // "dimethyl sulfoxide reductase subunit B" // "dimethyl sulfoxide reductase subunit C"	"dmsA" // "dmsB" // "dmsC"	"dimethyl sulfoxide reductase subunit A" // "dimethyl sulfoxide reductase subunit B" // "dimethyl sulfoxide reductase subunit C"
"DinJ-YafQ antitoxin/toxin complex / DNA-binding transcriptional repressor"	"yafQ" // "dinJ"	"ribosome-dependent mRNA interferase toxin YafQ" // "antitoxin/DNA-binding transcriptional repressor DinJ"
"dipeptide ABC transporter"	"dppD" // "dppF" // "dppB" // "dppC" // "dppA"	"dipeptide ABC transporter ATP binding subunit DppD" // "dipeptide ABC transporter ATP binding subunit DppF" // "dipeptide ABC transporter membrane subunit DppB" // "dipeptide ABC transporter membrane subunit DppC" // "dipeptide ABC transporter periplasmic binding protein"
"disulfide reductase"	"yfcG"	"disulfide reductase"
"disulfide reductase / organic hydroperoxide reductase"	"yghU"	"disulfide reductase / organic hydroperoxide reductase"
"dITP/XTP pyrophosphatase"	"rdgB"	"dITP/XTP pyrophosphatase"
"divisome protein complex FtsEX"	"ftsE" // "ftsX"	"cell division protein FtsE" // "cell division protein FtsX"
"DLP12 prophage; crossover junction endodeoxyribonuclease RusA"	"rusA"	"DLP12 prophage; crossover junction endodeoxyribonuclease RusA"
"DLP12 prophage; DNA base-flipping protein"	"ybcN"	"DLP12 prophage; DNA base-flipping protein"
"DNA gyrase"	"gyrA" // "gyrB"	"DNA gyrase subunit A" // "DNA gyrase subunit B"
"DNA polymerase III subunit &tau;"	"dnaX"	"DNA polymerase III subunit &tau;"
"DNA polymerase III, core enzyme"	"dnaE" // "dnaQ" // "holE"	"DNA polymerase III subunit &alpha;" // "DNA polymerase III subunit &epsilon;" // "DNA polymerase III subunit &theta;"
"DNA polymerase III, holoenzyme"	"holE" // "dnaQ" // "dnaE" // "holA" // "holB" // "dnaX" // "dnaN" // "holD" // "holC"	"DNA polymerase III subunit &theta;" // "DNA polymerase III subunit &epsilon;" // "DNA polymerase III subunit &alpha;" // "DNA polymerase III subunit &delta;" // "DNA polymerase III subunit &delta;'" // "DNA polymerase III subunit &tau;" // "&beta; sliding clamp" // "DNA polymerase III subunit &psi;" // "DNA polymerase III subunit &chi;"
"DNA polymerase III, preinitiation complex"	"dnaX" // "holB" // "holA"	"DNA polymerase III subunit &tau;" // "DNA polymerase III subunit &delta;'" // "DNA polymerase III subunit &delta;"
"DNA polymerase III, &psi;-&chi; subunit"	"holC" // "holD"	"DNA polymerase III subunit &chi;" // "DNA polymerase III subunit &psi;"
"DNA polymerase V"	"umuC" // "umuD"	"DNA polymerase V catalytic protein" // "DNA polymerase V protein UmuD"
"DNA replication inhibitor"	"cspD"	"DNA replication inhibitor"
"DNA topoisomerase IV"	"parE" // "parC"	"DNA topoisomerase IV subunit B" // "DNA topoisomerase IV subunit A"
"DNA topoisomerase IV subunit A"	"parC"	"DNA topoisomerase IV subunit A"
"DNA-binding protein HU-&alpha;"	"hupA"	"DNA-binding protein HU-&alpha;"
"DNA-binding transcriptional activator CaiF"	"caiF"	"DNA-binding transcriptional activator CaiF"
"DNA-binding transcriptional activator RhaS"	"rhaS"	"DNA-binding transcriptional activator RhaS"
"DNA-binding transcriptional activator/c-di-GMP phosphodiesterase PdeL"	"pdeL"	"DNA-binding transcriptional activator/c-di-GMP phosphodiesterase PdeL"
"DNA-binding transcriptional dual regulator AraC"	"araC"	"DNA-binding transcriptional dual regulator AraC"
"DNA-binding transcriptional dual regulator ArgP"	"argP"	"DNA-binding transcriptional dual regulator ArgP"
"DNA-binding transcriptional dual regulator ArgR"	"argR"	"DNA-binding transcriptional dual regulator ArgR"
"DNA-binding transcriptional dual regulator AsnC"	"asnC"	"DNA-binding transcriptional dual regulator AsnC"
"DNA-binding transcriptional dual regulator Cra"	"cra"	"DNA-binding transcriptional dual regulator Cra"
"DNA-binding transcriptional dual regulator CRP"	"crp"	"DNA-binding transcriptional dual regulator CRP"
"DNA-binding transcriptional dual regulator CueR-Cu<sup>+</sup>"	"cueR"	"DNA-binding transcriptional dual regulator CueR"
"DNA-binding transcriptional dual regulator CysB"	"cysB"	"DNA-binding transcriptional dual regulator CysB"
"DNA-binding transcriptional dual regulator DsdC"	"dsdC"	"DNA-binding transcriptional dual regulator DsdC"
"DNA-binding transcriptional dual regulator Fis"	"fis"	"DNA-binding transcriptional dual regulator Fis"
"DNA-binding transcriptional dual regulator FNR"	"fnr"	"DNA-binding transcriptional dual regulator FNR"
"DNA-binding transcriptional dual regulator HU"	"hupA" // "hupB"	"DNA-binding protein HU-&alpha;" // "DNA-binding protein HU-&beta;"
"DNA-binding transcriptional dual regulator HypT"	"hypT"	"DNA-binding transcriptional dual regulator HypT"
"DNA-binding transcriptional dual regulator IHF"	"ihfA" // "ihfB"	"integration host factor subunit &alpha;" // "integration host factor subunit &beta;"
"DNA-binding transcriptional dual regulator MetR"	"metR"	"DNA-binding transcriptional dual regulator MetR"
"DNA-binding transcriptional dual regulator ModE"	"modE"	"DNA-binding transcriptional dual regulator ModE"
"DNA-binding transcriptional dual regulator MurR"	"murR"	"DNA-binding transcriptional dual regulator MurR"
"DNA-binding transcriptional dual regulator NtrC"	"glnG"	"DNA-binding transcriptional dual regulator NtrC"
"DNA-binding transcriptional dual regulator PspF"	"pspF"	"DNA-binding transcriptional dual regulator PspF"
"DNA-binding transcriptional dual regulator TorR"	"torR"	"DNA-binding transcriptional dual regulator TorR"
"DNA-binding transcriptional repressor ArsR"	"arsR"	"DNA-binding transcriptional repressor ArsR"
"DNA-binding transcriptional repressor CytR"	"cytR"	"DNA-binding transcriptional repressor CytR"
"DNA-binding transcriptional repressor FrmR"	"frmR"	"DNA-binding transcriptional repressor FrmR"
"DNA-binding transcriptional repressor LexA"	"lexA"	"DNA-binding transcriptional repressor LexA"
"DNA-binding transcriptional repressor LsrR"	"lsrR"	"DNA-binding transcriptional repressor LsrR"
"DNA-binding transcriptional repressor MarR"	"marR"	"DNA-binding transcriptional repressor MarR"
"DNA-binding transcriptional repressor MngR"	"mngR"	"DNA-binding transcriptional repressor MngR"
"DNA-binding transcriptional repressor MprA"	"mprA"	"DNA-binding transcriptional repressor MprA"
"DNA-binding transcriptional repressor NsrR"	"nsrR"	"DNA-binding transcriptional repressor NsrR"
"DNA-binding transcriptional repressor PaaX"	"paaX"	"DNA-binding transcriptional repressor PaaX"
"DNA-binding transcriptional repressor PurR"	"purR"	"DNA-binding transcriptional repressor PurR"
"DNA-binding transcriptional repressor TreR"	"treR"	"DNA-binding transcriptional repressor TreR"
"DNA-binding transcriptional repressor TrpR"	"trpR"	"DNA-binding transcriptional repressor TrpR"
"DNA-binding transcriptional repressor Zur"	"zur"	"DNA-binding transcriptional repressor Zur"
"DNA-binding transcriptional repressor/NMN adenylyltransferase NadR"	"nadR"	"DNA-binding transcriptional repressor/NMN adenylyltransferase NadR"
"DnaA initiator-associating factor for replication initiation"	"diaA"	"DnaA initiator-associating factor for replication initiation"
"dodecenoyl-CoA &delta;-isomerase, enoyl-CoA hydratase, 3-hydroxybutyryl-CoA epimerase, 3-hydroxyacyl-CoA dehydrogenase"	"fadB"	"dodecenoyl-CoA &delta;-isomerase, enoyl-CoA hydratase, 3-hydroxybutyryl-CoA epimerase, 3-hydroxyacyl-CoA dehydrogenase"
"DosC-DosP complex"	"dosP" // "dosC"	"oxygen-sensing c-di-GMP phosphodiesterase DosP" // "diguanylate cyclase DosC"
"DsbG<SUB>reduced</SUB>"	"dsbG"	"DsbG<SUB>reduced</SUB>"
"dTDP-4-dehydro-6-deoxy-D-glucose transaminase"	"wecE"	"dTDP-4-dehydro-6-deoxy-D-glucose transaminase"
"dTDP-glucose 4,6-dehydratase 1"	"rfbB"	"dTDP-glucose 4,6-dehydratase 1"
"dTDP-glucose pyrophosphorylase"	"rfbA"	"dTDP-glucose pyrophosphorylase"
"dTDP-glucose pyrophosphorylase 2"	"rffH"	"dTDP-glucose pyrophosphorylase 2"
"dTDP-L-rhamnose synthetase complex"	"rfbC" // "rfbD"	DTDPDEHYDRHAMEPIM-MONOMER // DTDPDEHYRHAMREDUCT-MONOMER
"DUF892 domain-containing protein YciF"	"yciF"	"DUF892 domain-containing protein YciF"
"<I>Eco</I>KI restriction-modification system"	"hsdM" // "hsdR" // "hsdS"	"type I restriction enzyme EcoKI methyltransferase component" // "type I restriction enzyme EcoKI endonuclease component" // "type I restriction enzyme EcoKI specificity protein"
"EF-P-lysine lysyltransferase"	"epmA"	"EF-P-lysine lysyltransferase"
"enamine/imine deaminase, redox regulated chaperone"	"ridA"	"enamine/imine deaminase, redox regulated chaperone"
"endoribonuclease toxin MazF"	"mazF"	"endoribonuclease toxin MazF"
"energy transducing Ton complex"	"tonB" // "exbB" // "exbD"	"Ton complex subunit TonB" // "Ton complex subunit ExbB" // "Ton complex subunit ExbD"
"enolase"	"eno"	"enolase"
"enoyl-[acyl-carrier-protein] reductase"	"fabI"	"enoyl-[acyl-carrier-protein] reductase"
"Enterobacterial Common Antigen Biosynthesis Protein Complex"	"wzxE" // "wzyE" // "wzzE"	"lipid III flippase" // "enterobacterial common antigen polymerase" // "enterobacterial common antigen polysaccharide co-polymerase"
"<i>holo</i>-EntB dimer" // "phosphopantetheinyl transferase EntD" // "<i>holo</i> [EntF peptidyl-carrier protein]" // "2,3-dihydroxybenzoate-[aryl-carrier protein] ligase"	"entB" // "entD" // "entF" // "entE"	"enterobactin synthase component B" // "phosphopantetheinyl transferase EntD" // "apo-serine activating enzyme" // "2,3-dihydroxybenzoate-AMP ligase"
"erythronate-4-phosphate dehydrogenase"	"pdxB"	"erythronate-4-phosphate dehydrogenase"
"ethanol dehydrogenase / alcohol dehydrogenase"	"adhP"	"ethanol dehydrogenase / alcohol dehydrogenase"
"ethanolamine ammonia-lyase subunit &alpha;" // "ethanolamine ammonia-lyase subunit &beta;"	"eutB" // "eutC"	"ethanolamine ammonia-lyase subunit &alpha;" // "ethanolamine ammonia-lyase subunit &beta;"
"evolved &beta;-D-galactosidase"	"ebgA" // "ebgC"	"evolved &beta;-D-galactosidase subunit &alpha;" // "DUF386 domain-containing evolved &beta;-D-galactosidase subunit &beta;"
"excision nuclease UvrABC"	"uvrB" // "uvrC" // "uvrA"	"excision nuclease subunit B" // "excision nuclease subunit C" // "excision nuclease subunit A"
"exodeoxyribonuclease V"	"recD" // "recC" // "recB"	"exodeoxyribonuclease V subunit RecD" // "exodeoxyribonuclease V subunit RecC" // "exodeoxyribonuclease V subunit RecB"
"exodeoxyribonuclease VII"	"xseA" // "xseB"	"exodeoxyribonuclease VII subunit XseA" // "exodeoxyribonuclease VII subunit XseB"
"exopolyphosphatase"	"ppx"	"exopolyphosphatase"
"fatty acyl-CoA synthetase"	"fadD"	"fatty acyl-CoA synthetase"
"FecAR Signal Transduction System"	"fecA" // "fecR"	"ferric citrate outer membrane transporter" // "regulator for fec operon, periplasmic"
"ferric citrate ABC transporter"	"fecE" // "fecC" // "fecD" // "fecB"	"ferric citrate ABC transporter ATP binding subunit" // "ferric citrate ABC transporter membrane subunit FecC" // "ferric citrate ABC transporter membrane subunit FecD" // "ferric citrate ABC transporter periplasmic binding protein"
"ferric citrate outer membrane transport complex"	"fecA" // "exbD" // "exbB" // "tonB"	"ferric citrate outer membrane transporter" // "Ton complex subunit ExbD" // "Ton complex subunit ExbB" // "Ton complex subunit TonB"
"ferric coprogen outer membrane transport complex"	"fhuE" // "exbD" // "exbB" // "tonB"	"ferric coprogen/ferric rhodotorulic acid outer membrane transporter" // "Ton complex subunit ExbD" // "Ton complex subunit ExbB" // "Ton complex subunit TonB"
"ferric enterobactin ABC transporter"	"fepC" // "fepD" // "fepG" // "fepB"	"ferric enterobactin ABC transporter ATP binding subunit" // "ferric enterobactin ABC transporter membrane subunit FebD" // "ferric enterobactin ABC transporter membrane subunit FepG" // "ferric enterobactin ABC transporter periplasmic binding protein"
"ferric enterobactin outer membrane transport complex"	"exbD" // "exbB" // "tonB" // "fepA"	"Ton complex subunit ExbD" // "Ton complex subunit ExbB" // "Ton complex subunit TonB" // "ferric enterobactin outer membrane transporter"
"ferrichrome outer membrane transport complex"	"exbD" // "exbB" // "tonB" // "fhuA"	"Ton complex subunit ExbD" // "Ton complex subunit ExbB" // "Ton complex subunit TonB" // "ferrichrome outer membrane transporter/phage receptor"
"ferritin iron storage protein"	"ftnA"	"ferritin iron storage protein"
"FicT-FicA complex"	"fic" // "yhfG"	"putative adenosine monophosphate&mdash;protein transferase Fic" // "DUF2559 domain-containing protein YhfG"
"fimbrial complex"	"fimA" // "fimF" // "fimG" // "fimH"	"type 1 fimbriae major subunit" // "type 1 fimbriae minor subunit FimF" // "type 1 fimbriae minor subunit FimG" // "type 1 fimbriae D-mannose specific adhesin"
"FKBP-type peptidyl-prolyl <i>cis-trans</i> isomerase FklB"	"fklB"	"FKBP-type peptidyl-prolyl <i>cis-trans</i> isomerase FklB"
"FKBP-type peptidyl-prolyl <i>cis-trans</i> isomerase SlyD"	"slyD"	"FKBP-type peptidyl-prolyl <i>cis-trans</i> isomerase SlyD"
"flagellar export apparatus"	"flhA" // "flhB" // "fliO" // "fliP" // "fliQ" // "fliR" // "fliH" // "fliI" // "fliJ"	"flagellar biosynthesis protein FlhA" // "flagellar biosynthesis protein FlhB" // "flagellar biosynthesis protein FliO" // "flagellar biosynthesis protein FliP" // "flagellar biosynthesis protein FliQ" // "flagellar biosynthesis protein FliR" // "flagellar biosynthesis protein FliH" // "flagellum-specific ATP synthase FliI" // "flagellar biosynthesis protein FliJ"
"flagellar motor complex"	"fliN" // "fliM" // "fliG" // "flgH" // "motA" // "motB" // "flgB" // "flgC" // "flgF" // "flgG" // "flgI" // "fliF" // "fliE" // "fliL"	"flagellar motor switch protein FliN" // "flagellar motor switch protein FliM" // "flagellar motor switch protein FliG" // "flagellar L-ring protein" // "motility protein A" // "motility protein B" // "flagellar basal-body rod protein FlgB" // "flagellar basal-body rod protein FlgC" // "flagellar basal-body rod protein FlgF" // "flagellar basal-body rod protein FlgG" // "flagellar P-ring protein" // "flagellar basal-body MS-ring and collar protein" // "flagellar basal-body protein FliE" // "flagellar protein FliL"
"flagellar motor switch complex"	"fliG" // "fliM" // "fliN"	"flagellar motor switch protein FliG" // "flagellar motor switch protein FliM" // "flagellar motor switch protein FliN"
"flagellum"	"fliL" // "fliE" // "fliF" // "flgI" // "flgG" // "flgF" // "flgC" // "flgB" // "motB" // "motA" // "flgH" // "fliG" // "fliM" // "fliN" // "fliJ" // "fliI" // "fliH" // "fliR" // "fliQ" // "fliP" // "fliO" // "flhB" // "flhA" // "flgE" // "flgK" // "flgL" // "fliC" // "fliD"	"flagellar protein FliL" // "flagellar basal-body protein FliE" // "flagellar basal-body MS-ring and collar protein" // "flagellar P-ring protein" // "flagellar basal-body rod protein FlgG" // "flagellar basal-body rod protein FlgF" // "flagellar basal-body rod protein FlgC" // "flagellar basal-body rod protein FlgB" // "motility protein B" // "motility protein A" // "flagellar L-ring protein" // "flagellar motor switch protein FliG" // "flagellar motor switch protein FliM" // "flagellar motor switch protein FliN" // "flagellar biosynthesis protein FliJ" // "flagellum-specific ATP synthase FliI" // "flagellar biosynthesis protein FliH" // "flagellar biosynthesis protein FliR" // "flagellar biosynthesis protein FliQ" // "flagellar biosynthesis protein FliP" // "flagellar biosynthesis protein FliO" // "flagellar biosynthesis protein FlhB" // "flagellar biosynthesis protein FlhA" // "flagellar hook protein FlgE" // "flagellar hook-filament junction protein 1" // "flagellar hook-filament junction protein 2" // "flagellar filament structural protein" // "flagellar filament capping protein"
"FlhDC DNA-binding transcriptional dual regulator"	"flhD" // "flhC"	"DNA-binding transcriptional dual regulator FlhD" // "DNA-binding transcriptional dual regulator FlhC"
"FMN dependent NADH:quinone oxidoreductase"	"azoR"	"FMN dependent NADH:quinone oxidoreductase"
"FMNH<sub>2</sub>-dependent alkanesulfonate monooxygenase"	"ssuD"	"FMNH<sub>2</sub>-dependent alkanesulfonate monooxygenase"
"formate channel FocA"	"focA"	"formate channel FocA"
"formate dehydrogenase formation protein"	"fdhE"	"formate dehydrogenase formation protein"
"formate dehydrogenase N, subcomplex"	"fdnG" // "fdnH" // "fdnI"	"formate dehydrogenase N subunit &alpha;" // "formate dehydrogenase N subunit &beta;" // "formate dehydrogenase N subunit &gamma;"
"formate dehydrogenase N, subcomplex"	"fdnI" // "fdnH" // "fdnG"	"formate dehydrogenase N subunit &gamma;" // "formate dehydrogenase N subunit &beta;" // "formate dehydrogenase N subunit &alpha;"
"formate dehydrogenase O"	"fdoG" // "fdoH" // "fdoI"	"formate dehydrogenase O subunit &alpha;" // "formate dehydrogenase O subunit &beta;" // "formate dehydrogenase O subunit &gamma;"
"formate dehydrogenase H" // "hydrogenase 3"	"fdhF" // "hycE" // "hycB" // "hycG" // "hycF" // "hycC" // "hycD"	"formate dehydrogenase H" // "formate hydrogenlyase complex, hydrogenase 3 subunit HycE" // "formate hydrogenlyase complex, iron-sulfur protein HycB" // "formate hydrogenlyase complex, hydrogenase 3 subunit HycG" // "formate hydrogenlyase complex, iron-sulfur protein HycF" // "formate hydrogenlyase complex, membrane subunit HycC" // "formate hydrogenlyase complex, membrane subunit HycD"
"formyl-CoA transferase"	"frc"	"formyl-CoA transferase"
"formyltetrahydrofolate deformylase"	"purU"	"formyltetrahydrofolate deformylase"
"free methionine-(<i>R</i>)-sulfoxide reductase"	"msrC"	"free methionine-(<i>R</i>)-sulfoxide reductase"
"fructose 1,6-bisphosphatase YggF"	"yggF"	"fructose 1,6-bisphosphatase YggF"
"fructose-1,6-bisphosphatase 1"	"fbp"	"fructose-1,6-bisphosphatase 1"
"fructose-1,6-bisphosphatase 2"	"glpX"	"fructose-1,6-bisphosphatase 2"
"fructose-6-phosphate aldolase 1"	"fsaA"	"fructose-6-phosphate aldolase 1"
"fructose-bisphosphate aldolase class I"	"fbaB"	"fructose-bisphosphate aldolase class I"
"fructose-bisphosphate aldolase class II"	"fbaA"	"fructose-bisphosphate aldolase class II"
"fructose-specific PTS enzyme II"	"fruB" // "fruA"	"fructose-specific PTS multiphosphoryl transfer protein FruB" // "fructose-specific PTS multiphosphoryl transfer protein FruA"
"fructoselysine 3-epimerase"	"frlC"	"fructoselysine 3-epimerase"
"fructoselysine 6-phosphate deglycase"	"frlB"	"fructoselysine 6-phosphate deglycase"
"FtsH/HflKC protease complex"	"hflC" // "hflK" // "ftsH"	"regulator of FtsH protease" // "regulator of FtsH protease" // "ATP-dependent zinc metalloprotease FtsH"
"FtsLBQ cell division complex"	"ftsQ" // "ftsB" // "ftsL"	"cell division protein FtsQ" // "cell division protein FtsB" // "cell division protein FtsL"
"fumarase A"	"fumA"	"fumarase A"
"fumarase B"	"fumB"	"fumarase B"
"fumarase C"	"fumC"	"fumarase C"
"fumarate reductase flavoprotein subunit" // "fumarate reductase iron-sulfur protein" // "fumarate reductase membrane protein FrdC" // "fumarate reductase membrane protein FrdD"	"frdA" // "frdB" // "frdC" // "frdD"	"fumarate reductase flavoprotein subunit" // "fumarate reductase iron-sulfur protein" // "fumarate reductase membrane protein FrdC" // "fumarate reductase membrane protein FrdD"
"Fur-Fe<sup>2+</sup> DNA-binding transcriptional dual regulator"	"fur"	"DNA-binding transcriptional dual regulator Fur"
"fused 4'-phosphopantothenoylcysteine decarboxylase and phosphopantothenoylcysteine synthetase"	"dfp"	"fused 4'-phosphopantothenoylcysteine decarboxylase and phosphopantothenoylcysteine synthetase"
"fused aspartate kinase/homoserine dehydrogenase 1"	"thrA"	"fused aspartate kinase/homoserine dehydrogenase 1"
"fused aspartate kinase/homoserine dehydrogenase 2"	"metL"	"fused aspartate kinase/homoserine dehydrogenase 2"
"fused chorismate mutase/prephenate dehydratase"	"pheA"	"fused chorismate mutase/prephenate dehydratase"
"fused chorismate mutase/prephenate dehydrogenase"	"tyrA"	"fused chorismate mutase/prephenate dehydrogenase"
"fused diaminohydroxyphosphoribosylaminopyrimidine deaminase / 5-amino-6-(5-phosphoribosylamino)uracil reductase"	"ribD"	"fused diaminohydroxyphosphoribosylaminopyrimidine deaminase / 5-amino-6-(5-phosphoribosylamino)uracil reductase"
"fused DNA-binding transcriptional repressor / proline dehydrogenase / 1-pyrroline-5-carboxylate dehydrogenase PutA"	"putA"	"fused DNA-binding transcriptional repressor / proline dehydrogenase / 1-pyrroline-5-carboxylate dehydrogenase PutA"
"fused glutathionylspermidine amidase / glutathionylspermidine synthetase"	"gss"	"fused glutathionylspermidine amidase / glutathionylspermidine synthetase"
"fused heptose 7-phosphate kinase/heptose 1-phosphate adenyltransferase"	"rfaE"	"fused heptose 7-phosphate kinase/heptose 1-phosphate adenyltransferase"
"fused N-acetylglucosamine-1-phosphate uridyltransferase and glucosamine-1-phosphate acetyltransferase"	"glmU"	"fused N-acetylglucosamine-1-phosphate uridyltransferase and glucosamine-1-phosphate acetyltransferase"
"fused UDP-4-amino-4-deoxy-L-arabinose formyltransferase/UDP-glucuronate dehydrogenase"	"arnA"	"fused UDP-4-amino-4-deoxy-L-arabinose formyltransferase/UDP-glucuronate dehydrogenase"
"GadE-RcsB DNA-binding transcriptional activator"	"rcsB" // "gadE"	"DNA-binding transcriptional activator RcsB" // "DNA-binding transcriptional activator GadE"
"galactitol-1-phosphate 5-dehydrogenase"	"gatD"	"galactitol-1-phosphate 5-dehydrogenase"
"galactitol-specific PTS enzyme II"	"gatC" // "gatB" // "gatA"	"galactitol-specific PTS enzyme IIC component" // "galactitol-specific PTS enzyme IIB component" // "galactitol-specific PTS enzyme IIA component"
"galactofuranose ABC transporter"	"yjfF" // "ytfR" // "ytfT" // "ytfQ"	"galactofuranose ABC transporter putative membrane subunit YjtF" // "galactofuranose ABC transporter putative ATP binding subunit" // "galactofuranose ABC transporter putative membrane subunit YtfT" // "galactofuranose ABC transporter periplasmic binding protein"
"galactosamine-specific PTS enzyme II (cryptic)"	"agaB" // "agaC" // "agaD"	"galactosamine-specific PTS enzyme IIB component" // "galactosamine-specific PTS enzyme IIC component" // "galactosamine-specific PTS enzyme IID component"
"galactose-1-phosphate uridylyltransferase"	"galT"	"galactose-1-phosphate uridylyltransferase"
"galactoside <i>O</i>-acetyltransferase"	"lacA"	"galactoside <i>O</i>-acetyltransferase"
"&gamma;-aminobutyraldehyde dehydrogenase"	"patD"	"&gamma;-aminobutyraldehyde dehydrogenase"
"&gamma;-butyrobetainyl-CoA:carnitine CoA transferase"	"caiB"	"&gamma;-butyrobetainyl-CoA:carnitine CoA transferase"
"&gamma;-glutamyl-&gamma;-aminobutyrate hydrolase"	"puuD"	"&gamma;-glutamyl-&gamma;-aminobutyrate hydrolase"
"GDP-fucose synthase"	"fcl"	"GDP-fucose synthase"
"GDP-mannose 4,6-dehydratase"	"gmd"	"GDP-mannose 4,6-dehydratase"
"GDP-mannose hydrolase"	"nudK"	"GDP-mannose hydrolase"
"GDP-mannose mannosyl hydrolase"	"gmm"	"GDP-mannose mannosyl hydrolase"
"glucosamine-6-phosphate deaminase"	"nagB"	"glucosamine-6-phosphate deaminase"
"glucose-1-phosphatase"	"agp"	"glucose-1-phosphatase"
"glucose-1-phosphate adenylyltransferase"	"glgC"	"glucose-1-phosphate adenylyltransferase"
"glucose-6-phosphate isomerase"	"pgi"	"glucose-6-phosphate isomerase"
"glucose-specific PTS enzyme II"	"ptsG" // "crr"	"glucose-specific PTS enzyme IIBC component" // "Enzyme IIA<sup>Glc</sup>"
"glutamate / aspartate ABC transporter"	"gltI" // "gltK" // "gltJ" // "gltL"	"glutamate/aspartate ABC transporter periplasmic binding protein" // "glutamate/aspartate ABC transporter membrane subunit GltK" // "glutamate/aspartate ABC transporter membrane subunit GltJ" // "glutamate/aspartate ABC transporter ATP binding subunit"
"glutamate 5-kinase"	"proB"	"glutamate 5-kinase"
"glutamate decarboxylase A"	"gadA"	"glutamate decarboxylase A"
"glutamate decarboxylase B"	"gadB"	"glutamate decarboxylase B"
"glutamate dehydrogenase"	"gdhA"	"glutamate dehydrogenase"
"glutamate synthase"	"gltB" // "gltD"	"glutamate synthase subunit GltB" // "glutamate synthase subunit GltD"
"glutamate synthase"	"gltD" // "gltB"	"glutamate synthase subunit GltD" // "glutamate synthase subunit GltB"
"glutamate&mdash;pyruvate aminotransferase AlaA"	"alaA"	"glutamate&mdash;pyruvate aminotransferase AlaA"
"glutamate&mdash;pyruvate aminotransferase AlaC"	"alaC"	"glutamate&mdash;pyruvate aminotransferase AlaC"
"glutamate-1-semialdehyde aminotransferase"	"hemL"	"glutamate-1-semialdehyde aminotransferase"
"glutamate-5-semialdehyde dehydrogenase"	"proA"	"glutamate-5-semialdehyde dehydrogenase"
"glutamate-putrescine ligase"	"puuA"	"glutamate-putrescine ligase"
"glutaminase 1"	"glsA"	"glutaminase 1"
"glutaminase 2"	"glsB"	"glutaminase 2"
"glutamine synthetase"	"glnA"	"glutamine synthetase"
"glutamyl-tRNA reductase"	"hemA"	"glutamyl-tRNA reductase"
"glutaredoxin 4"	"grxD"	"glutaredoxin 4"
"glutathione / L-cysteine ABC exporter CydDC"	"cydD" // "cydC"	"glutathione/L-cysteine ABC exporter subunit CydD" // "glutathione/L-cysteine ABC exporter subunit CydC"
"glutathione ABC transporter"	"gsiA" // "gsiB" // "gsiD" // "gsiC"	"glutathione ABC transporter ATP binding subunit GsiA" // "glutathione ABC transporter periplasmic binding protein" // "glutathione ABC transporter membrane subunit GsiD" // "glutathione ABC transporter membrane subunit GsiC"
"glutathione hydrolase"	"ggt"	"glutathione hydrolase proenzyme" // "glutathione hydrolase proenzyme"
"glutathione reductase (NADPH)"	"gor"	"glutathione reductase (NADPH)"
"glutathione <i>S</i>-transferase GstA"	"gstA"	"glutathione <i>S</i>-transferase GstA"
"glutathione synthetase"	"gshB"	"glutathione synthetase"
"glutathionyl-hydroquinone reductase YqjG"	"yqjG"	"glutathionyl-hydroquinone reductase YqjG"
"glyceraldehyde-3-phosphate dehydrogenase A"	"gapA"	"glyceraldehyde-3-phosphate dehydrogenase A"
"glycerol facilitator"	"glpF"	"glycerol facilitator"
"glycerol kinase"	"glpK"	"glycerol kinase"
"glycerol-3-phosphate dehydrogenase"	"gpsA"	"glycerol-3-phosphate dehydrogenase"
"glycerophosphoryl diester phosphodiesterase"	"glpQ"	"glycerophosphoryl diester phosphodiesterase"
"glycine betaine ABC transporter"	"proV" // "proW" // "proX"	"glycine betaine ABC transporter ATP binding subunit ProV" // "glycine betaine ABC transporter membrane subunit ProW" // "glycine betaine ABC transporter periplasmic binding protein ProX"
"glycine betaine ABC transporter, non-osmoregulatory"	"osmF" // "yehY" // "yehX" // "yehW"	"glycine betaine ABC transporter periplasmic binding protein OsmF" // "glycine betaine ABC transporter membrane subunit YehY" // "glycine betaine ABC transporter ATP binding subunit YehX" // "glycine betaine ABC transporter membrane subunit YehW"
"glycine cleavage system"	"lpd" // "gcvP" // "gcvH" // "gcvT"	"lipoamide dehydrogenase" // "glycine decarboxylase" // "glycine cleavage system H protein" // GCVT-MONOMER
"glycine decarboxylase"	"gcvP"	"glycine decarboxylase"
"glycine&mdash;tRNA ligase"	"glyS" // "glyQ"	"glycine&mdash;tRNA ligase subunit &beta;" // "glycine&mdash;tRNA ligase subunit &alpha;"
"glycogen phosphorylase"	"glgP"	"glycogen phosphorylase"
"glycolate dehydrogenase"	"glcD" // "glcE" // "glcF"	"glycolate dehydrogenase, putative FAD-linked subunit" // "glycolate dehydrogenase, putative FAD-binding subunit" // "glycolate dehydrogenase, putative iron-sulfur subunit"
"glyoxalase I"	"gloA"	"glyoxalase I"
"glyoxylate carboligase"	"gcl"	"glyoxylate carboligase"
"glyoxylate reductase"	"ghrB"	"glyoxylate reductase"
"GMP reductase"	"guaC"	"GMP reductase"
"GMP synthetase"	"guaA"	"GMP synthetase"
"GroEL-GroES chaperonin complex"	"groL" // "groS"	"GroEL chaperonin" // "GroES cochaperonin"
"Grx4-BolA complex"	"bolA" // "grxD"	"DNA-binding transcriptional dual regulator BolA" // "glutaredoxin 4"
"Grx4-IbaG complex"	"ibaG" // "grxD"	"acid stress protein IbaG" // "glutaredoxin 4"
"GTP cyclohydrolase 1"	"folE"	"GTP cyclohydrolase 1"
"GTP cyclohydrolase 2"	"ribA"	"GTP cyclohydrolase 2"
"guanosine-5'-triphosphate,3'-diphosphate phosphatase"	"gpp"	"guanosine-5'-triphosphate,3'-diphosphate phosphatase"
"guanylate kinase"	"gmk"	"guanylate kinase"
"HdeA monomer, chaperone active form"	"hdeA"	"HdeA monomer, chaperone active form"
"heat shock protein, hemimethylated DNA-binding protein"	"hspQ"	"heat shock protein, hemimethylated DNA-binding protein"
"heme trafficking system CcmABCDE"	"ccmD" // "ccmB" // "ccmA" // "ccmE" // "ccmC"	"heme trafficking system membrane protein CcmD" // "heme trafficking system membrane protein CcmB" // "heme trafficking system ATP-binding protein" // "periplasmic heme chaperone" // "heme trafficking system membrane protein CcmC"
"heme-containing peroxidase/deferrochelatase"	"efeB"	"heme-containing peroxidase/deferrochelatase"
"HflK-HflC complex; regulator of FtsH protease"	"hflK" // "hflC"	"regulator of FtsH protease" // "regulator of FtsH protease"
"HigB-HigA toxin/antitoxin complex and DNA-binding transcriptional repressor"	"higB" // "higA"	"ribosome-dependent mRNA interferase toxin HigB" // "antitoxin/DNA-binding transcriptional repressor HigA"
"HipAB toxin/antitoxin complex / DNA-binding transcriptional repressor"	"hipB" // "hipA"	"antitoxin/DNA-binding transcriptional repressor HipB" // "serine/threonine kinase HipA"
"histidinal/histidinol dehydrogenase"	"hisD"	"histidinal/histidinol dehydrogenase"
"histidine ABC transporter"	"hisP" // "hisM" // "hisQ" // "hisJ"	"lysine/arginine/ornithine ABC transporter / histidine ABC transporter, ATP binding subunit" // "lysine/arginine/ornithine ABC transporter / histidine ABC transporter, membrane subunit HisM" // "lysine/arginine/ornithine ABC transporter / histidine ABC transporter, membrane subunit HisQ" // "histidine ABC transporter periplasmic binding protein"
"histidine&mdash;tRNA ligase"	"hisS"	"histidine&mdash;tRNA ligase"
"histidinol-phosphate aminotransferase"	"hisC"	"histidinol-phosphate aminotransferase"
"<i>holo</i> EntB"	"entB"	"enterobactin synthase component B"
"holo-[acyl-carrier-protein] synthase"	"acpS"	"holo-[acyl-carrier-protein] synthase"
"holocytochrome <I>c</I> synthetase"	"ccmE" // "ccmF" // "ccmG" // "ccmH"	"periplasmic heme chaperone" // "holocytochrome <I>c</I> synthetase membrane subunit CcmF" // "holocytochrome <I>c</I> synthetase - thiol:disulfide oxidoreductase CcmG" // "holocytochrome <I>c</I> synthetase - thiol:disulfide oxidoreductase CcmH"
"homoserine kinase"	"thrB"	"homoserine kinase"
"homoserine <i>O</i>-succinyltransferase"	"metA"	"homoserine <i>O</i>-succinyltransferase"
"HslVU protease"	"hslU" // "hslV"	"ATPase component of the HslVU protease" // "peptidase component of the HslVU protease"
"hydrogenase 1"	"hyaA" // "hyaB" // "hyaC"	"hydrogenase 1 small subunit" // "hydrogenase 1 large subunit" // "hydrogenase 1 cytochrome <i>b</i> subunit"
"hydrogenase 1, oxygen tolerant hydrogenase"	"hyaC" // "hyaB" // "hyaA"	"hydrogenase 1 cytochrome <i>b</i> subunit" // "hydrogenase 1 large subunit" // "hydrogenase 1 small subunit"
"hydrogenase 2"	"hybA" // "hybB" // "hybO" // "hybC"	"hydrogenase 2 iron-sulfur protein" // "hydrogenase 2 membrane subunit" // "hydrogenase 2 small subunit" // "hydrogenase 2 large subunit"
"hydrogenase 3"	"hycD" // "hycC" // "hycF" // "hycG" // "hycB" // "hycE"	"formate hydrogenlyase complex, membrane subunit HycD" // "formate hydrogenlyase complex, membrane subunit HycC" // "formate hydrogenlyase complex, iron-sulfur protein HycF" // "formate hydrogenlyase complex, hydrogenase 3 subunit HycG" // "formate hydrogenlyase complex, iron-sulfur protein HycB" // "formate hydrogenlyase complex, hydrogenase 3 subunit HycE"
"hydrogenase 4"	"hyfG" // "hyfI" // "hyfA" // "hyfB" // "hyfC" // "hyfD" // "hyfE" // "hyfF" // "hyfH"	"hydrogenase 4 catalytic subunit HyfG" // "hydrogenase 4 catalytic subunit HyfI" // "hydrogenase 4 component A" // "hydrogenase 4 component B" // "hydrogenase 4 component C" // "hydrogenase 4 component D" // "hydrogenase 4 component E" // "hydrogenase 4 component F" // "hydrogenase 4 component H"
"hydrogenase isoenzymes nickel incorporation protein HypB"	"hypB"	"hydrogenase isoenzymes nickel incorporation protein HypB"
"hydroperoxidase I"	"katG"	"hydroperoxidase I"
"hydroxyethylthiazole kinase"	"thiM"	"hydroxyethylthiazole kinase"
"hydroxyisourate hydrolase / transthyretin-related protein"	"yedX"	"hydroxyisourate hydrolase / transthyretin-related protein"
"hydroxypyruvate isomerase"	"hyi"	"hydroxypyruvate isomerase"
"HypA-HypB heterodimer"	"hypA" // "hypB"	"hydrogenase 3 nickel incorporation protein HypA" // "hydrogenase isoenzymes nickel incorporation protein HypB"
"HypCD complex involved in hydrogenase maturation"	"hypD" // "hypC"	"Fe-(CN)<sub>2</sub>CO cofactor assembly scaffold protein HypD" // "hydrogenase 3 maturation protein HypC"
"hypoxanthine phosphoribosyltransferase"	"hpt"	"hypoxanthine phosphoribosyltransferase"
"imidazole glycerol phosphate synthase subunit HisH" // "imidazole glycerol phosphate synthase subunit HisF"	"hisH" // "hisF"	"imidazole glycerol phosphate synthase subunit HisH" // "imidazole glycerol phosphate synthase subunit HisF"
"imidazoleglycerol-phosphate dehydratase / histidinol-phosphatase"	"hisB"	"imidazoleglycerol-phosphate dehydratase / histidinol-phosphatase"
"IMP dehydrogenase"	"guaB"	"IMP dehydrogenase"
"inorganic pyrophosphatase"	"ppa"	"inorganic pyrophosphatase"
"inosine/guanosine kinase"	"gsk"	"inosine/guanosine kinase"
"intermembrane phospholipid transport system"	"mlaB" // "mlaD" // "mlaE" // "mlaF"	"intermembrane phospholipid transport system protein MlaB" // "intermembrane phospholipid transport system, substrate binding protein MlaD" // "intermembrane phospholipid transport system, integral membrane subunit MlaE" // "intermembrane phospholipid transport system, ATP binding subunit MlaF"
"intermembrane transport protein PqiB"	"pqiB"	"intermembrane transport protein PqiB"
"iron(III) hydroxamate ABC transporter"	"fhuC" // "fhuB" // "fhuD"	"iron(III) hydroxamate ABC transporter ATP binding subunit" // "iron(III) hydroxamate ABC transporter membrane subunit" // "iron(III) hydroxamate ABC transporter periplasmic binding protein"
"iron-sulfur cluster carrier protein NfuA"	"nfuA"	"iron-sulfur cluster carrier protein NfuA"
"iron-sulfur cluster insertion protein ErpA"	"erpA"	"iron-sulfur cluster insertion protein ErpA"
"iron-sulfur cluster insertion protein IscA"	"iscA"	"iron-sulfur cluster insertion protein IscA"
"iron-sulfur cluster insertion protein SufA"	"sufA"	"iron-sulfur cluster insertion protein SufA"
"IS2 element protein InsA"	"insC-1"	"IS2 element protein InsA"
"isoaspartyl dipeptidase"	"iadA"	"isoaspartyl dipeptidase"
"isoaspartyl dipeptidase / asparaginase III"	"iaaA"	"isoaspartyl dipeptidase proenzyme" // "isoaspartyl dipeptidase proenzyme"
"isochorismate synthase MenF"	"menF"	"isochorismate synthase MenF"
"isocitrate dehydrogenase"	"icd"	"isocitrate dehydrogenase"
"isocitrate dehydrogenase kinase/phosphatase"	"aceK"	"isocitrate dehydrogenase kinase/phosphatase"
"isocitrate lyase"	"aceA"	"isocitrate lyase"
"ITPase/XTPase"	"yjjX"	"ITPase/XTPase"
"K<sup>+</sup> : H<sup>+</sup> antiporter KefC"	"kefC"	"K<sup>+</sup> : H<sup>+</sup> antiporter KefC"
"K<sup>+</sup> channel Kch"	"kch"	"K<sup>+</sup> channel Kch"
"K<sup>+</sup> transporting P-type ATPase"	"kdpF" // "kdpA" // "kdpB" // "kdpC"	"K<sup>+</sup> transporting P-type ATPase subunit KdpF" // "K<sup>+</sup> transporting P-type ATPase subunit KdpA" // "K<sup>+</sup> transporting P-type ATPase subunit KdpB" // "K<sup>+</sup> transporting P-type ATPase subunit KdpC"
"KdpE-Phosphorylated"	"kdpE"	"DNA-binding transcriptional activator KdpE"
"ketol-acid reductoisomerase (NADP<sup>+</sup>)"	"ilvC"	"ketol-acid reductoisomerase (NADP<sup>+</sup>)"
"KHG/KDPG aldolase"	"eda"	"KHG/KDPG aldolase"
"L(+)-tartrate dehydratase subunit &alpha;" // "L(+)-tartrate dehydratase subunit &beta;"	"ttdA" // "ttdB"	"L(+)-tartrate dehydratase subunit &alpha;" // "L(+)-tartrate dehydratase subunit &beta;"
"L-1,2-propanediol dehydrogenase / glycerol dehydrogenase"	"gldA"	"L-1,2-propanediol dehydrogenase / glycerol dehydrogenase"
"L-1,2-propanediol oxidoreductase"	"fucO"	"L-1,2-propanediol oxidoreductase"
"L-amino acid N-acyltransferase"	"mnaT"	"L-amino acid N-acyltransferase"
"L-arabinose isomerase"	"araA"	"L-arabinose isomerase"
"L-arginine ABC transporter"	"artJ" // "artQ" // "artM" // "artP"	"L-arginine ABC transporter periplasmic binding protein" // "L-arginine ABC transporter membrane subunit ArtQ" // "L-arginine ABC transporter membrane subunit ArtM" // "L-arginine ABC transporter ATP binding subunit"
"L-ascorbate specific PTS enzyme II"	"ulaC" // "ulaB" // "ulaA"	"L-ascorbate specific PTS enzyme IIA component" // "L-ascorbate specific PTS enzyme IIB component" // "L-ascorbate specific PTS enzyme IIC component"
"L-ascorbate-6-phosphate lactonase"	"ulaG"	"L-ascorbate-6-phosphate lactonase"
"L-asparaginase 1"	"ansA"	"L-asparaginase 1"
"L-asparaginase 2"	"ansB"	"L-asparaginase 2"
"L-carnitine:&gamma;-butyrobetaine antiporter"	"caiT"	"L-carnitine:&gamma;-butyrobetaine antiporter"
"L-cysteine desulfurase"	"sufS"	"L-cysteine desulfurase"
"L-fucose isomerase"	"fucI"	"L-fucose isomerase"
"L-fucose mutarotase"	"fucU"	"L-fucose mutarotase"
"L-fuculose-phosphate aldolase"	"fucA"	"L-fuculose-phosphate aldolase"
"L-glutamine ABC transporter"	"glnQ" // "glnP" // "glnH"	"L-glutamine ABC transporter ATP binding subunit" // "L-glutamine ABC transporter membrane subunit" // "L-glutamine ABC transporter periplasmic binding protein"
"L-glutamine&mdash;D-fructose-6-phosphate aminotransferase"	"glmS"	"L-glutamine&mdash;D-fructose-6-phosphate aminotransferase"
"L-methionine/D-methionine ABC transporter"	"metN" // "metI" // "metQ"	"L-methionine/D-methionine ABC transporter ATP binding subunit" // "L-methionine/D-methionine ABC transporter membrane subunit" // "L-methionine/D-methionine ABC transporter membrane anchored binding protein"
"L-rhamnonate dehydratase"	"rhmD"	"L-rhamnonate dehydratase"
"L-rhamnose isomerase"	"rhaA"	"L-rhamnose isomerase"
"L-rhamnose mutarotase"	"rhaM"	"L-rhamnose mutarotase"
"L-ribulose-5-phosphate 4-epimerase AraD"	"araD"	"L-ribulose-5-phosphate 4-epimerase AraD"
"L-serine deaminase III"	"tdcG"	"L-serine deaminase III"
"L-valine exporter"	"ygaZ" // "ygaH"	"L-valine exporter subunit YgaZ" // "L-valine exporter subunit YgaH"
"L-xylulose kinase"	"lyxK"	"L-xylulose kinase"
"large conductance mechanosensitive channel"	"mscL"	"large conductance mechanosensitive channel"
"leucine / L-phenylalanine ABC transporter"	"livK" // "livM" // "livH" // "livG" // "livF"	"L-leucine/L-phenylalanine ABC transporter periplasmic binding protein" // "branched chain amino acid/phenylalanine ABC transporter membrane subunit LivM" // "branched chain amino acid/phenylalanine ABC transporter membrane subunit LivH" // "branched chain amino acid/phenylalanine ABC transporter ATP binding subunit LivG" // "branched chain amino acid/phenylalanine ABC transporter ATP binding subunit LivF"
"lipid A disaccharide synthase"	"lpxB"	"lipid A disaccharide synthase"
"lipid hydroperoxide peroxidase"	"tpx"	"lipid hydroperoxide peroxidase"
"Lipid IV<sub>A</sub> palmitoyltransferase"	"pagP"	"Lipid IV<sub>A</sub> palmitoyltransferase"
"lipoamide dehydrogenase"	"lpd"	"lipoamide dehydrogenase"
"lipopolysaccharide transport system"	"lptE" // "lptD" // "lptG" // "lptC" // "lptA" // "lptB" // "lptF"	"lipopolysaccharide assembly protein LptE" // "lipopolysaccharide assembly protein LptD" // "lipopolysaccharide transport system protein LptG" // "lipopolysaccharide transport system protein LptC" // "lipopolysaccharide transport system protein LptA" // "lipopolysaccharide transport system ATP binding protein" // "lipopolysaccharide transport system protein LptF"
"lipopolysaccharide transport system - outer membrane assembly complex"	"lptD" // "lptE"	"lipopolysaccharide assembly protein LptD" // "lipopolysaccharide assembly protein LptE"
"lipoprotein NlpI"	"nlpI"	"lipoprotein NlpI"
"lipoprotein release complex"	"lolE" // "lolD" // "lolC"	"lipoprotein release complex - inner membrane subunit" // "lipoprotein release complex - ATP binding subunit" // "lipoprotein release complex - inner membrane subunit"
"lipoyl synthase"	"lipA"	"lipoyl synthase"
"Lon protease"	"lon"	"Lon protease"
"low-specificity L-threonine aldolase"	"ltaE"	"low-specificity L-threonine aldolase"
"lysine / arginine / ornithine ABC transporter"	"hisQ" // "hisP" // "hisM" // "argT"	"lysine/arginine/ornithine ABC transporter / histidine ABC transporter, membrane subunit HisQ" // "lysine/arginine/ornithine ABC transporter / histidine ABC transporter, ATP binding subunit" // "lysine/arginine/ornithine ABC transporter / histidine ABC transporter, membrane subunit HisM" // "lysine/arginine/ornithine ABC transporter periplasmic binding protein"
"lysine decarboxylase 1"	"cadA"	"lysine decarboxylase 1"
"lysine decarboxylase 2"	"ldcC"	"lysine decarboxylase 2"
"lysine&mdash;tRNA ligase, constitutive"	"lysS"	"lysine&mdash;tRNA ligase, constitutive"
"lysine&mdash;tRNA ligase/Ap<sub>4</sub>A synthetase/Ap<sub>3</sub>A synthetase"	"lysU"	"lysine&mdash;tRNA ligase/Ap<sub>4</sub>A synthetase/Ap<sub>3</sub>A synthetase"
"macrodomain Ter protein"	"matP"	"macrodomain Ter protein"
"macrolide ABC exporter"	"tolC" // "macB" // "macA"	"outer membrane channel TolC" // "macrolide ABC exporter, ATP binding/membrane subunit" // "macrolide ABC exporter membrane fusion protein"
"malate dehydrogenase"	"maeB"	"malate dehydrogenase"
"malate dehydrogenase"	"mdh"	"malate dehydrogenase"
"malate dehydrogenase, NAD-requiring"	"maeA"	"malate dehydrogenase, NAD-requiring"
"maltodextrin phosphorylase"	"malP"	"maltodextrin phosphorylase"
"maltose ABC transporter"	"malK" // "malF" // "malG" // "malE"	"maltose ABC transporter ATP binding subunit" // "maltose ABC transporter membrane subunit MalF" // "maltose ABC transporter membrane subunit MalG" // "maltose ABC transporter periplasmic binding protein"
"maltose <i>O</i>-acetyltransferase"	"maa"	"maltose <i>O</i>-acetyltransferase"
"maltose outer membrane porin / phage lambda receptor protein"	"lamB"	"maltose outer membrane porin / phage lambda receptor protein"
"mannitol-specific PTS enzyme II CmtBA"	"cmtB" // "cmtA"	"mannitol-specific PTS enzyme IIA component CmtB" // "mannitol-specific PTS enzyme IICB component CmtA"
"mannitol-specific PTS enzyme IICBA component"	"mtlA"	"mannitol-specific PTS enzyme IICBA component"
"mannose-specific PTS enzyme II"	"manZ" // "manY" // "manX"	"mannose-specific PTS enzyme IID component" // "mannose-specific PTS enzyme IIC component" // "mannose-specific PTS enzyme IIAB component"
"mannose-specific PTS enzyme IIAB component"	"manX"	"mannose-specific PTS enzyme IIAB component"
"MazE-MazF antitoxin/toxin complex / DNA-binding transcriptional repressor"	"mazF" // "mazE"	"endoribonuclease toxin MazF" // "antitoxin of the MazF-MazE toxin-antitoxin system MazE"
"McrBC restriction endonuclease"	"mcrB" // "mcrC"	"5-methylcytosine-specific restriction enzyme subunit McrB" // "5-methylcytosine-specific restriction enzyme subunit McrC"
"menaquinol:trimethylamine <i>N</i>-oxide oxidoreductase I"	"torC" // "torA"	"cytochrome <i>c</i> menaquinol dehydrogenase TorC" // "trimethylamine <i>N</i>-oxide reductase 1"
"methionine adenosyltransferase"	"metK"	"methionine adenosyltransferase"
"methionine&mdash;tRNA ligase"	"metG"	"methionine&mdash;tRNA ligase"
"methyl-accepting chemotaxis protein Tap"	"tap"	"methyl-accepting chemotaxis protein Tap"
"methyl-accepting chemotaxis protein Tar"	"tar"	"methyl-accepting chemotaxis protein Tar"
"methyl-accepting chemotaxis protein Trg"	"trg"	"methyl-accepting chemotaxis protein Trg"
"methyl-accepting chemotaxis protein Tsr"	"tsr"	"methyl-accepting chemotaxis protein Tsr"
"methylglyoxal synthase"	"mgsA"	"methylglyoxal synthase"
"methylmalonyl-CoA decarboxylase"	"scpB"	"methylmalonyl-CoA decarboxylase"
"methylmalonyl-CoA mutase"	"scpA"	"methylmalonyl-CoA mutase"
"methylphosphonate degradation complex"	"phnL" // "phnH" // "phnG" // "phnI"	"methylphosphonate degradation complex subunit PhnL" // "carbon-phosphorus lyase core complex subunit PhnH" // "carbon-phosphorus lyase core complex subunit PhnG" // "carbon-phosphorus lyase core complex subunit PhnI"
"MetJ-S-adenosylmethionine DNA-binding transcriptional repressor"	"metJ"	"DNA-binding transcriptional repressor MetJ"
"miniconductance mechanosensitive channel MscM"	"mscM"	"miniconductance mechanosensitive channel MscM"
"miniconductance mechanosensitive channel YbdG"	"ybdG"	"miniconductance mechanosensitive channel YbdG"
"Mlc-PtsG"	"ptsG" // "mlc"	"glucose-specific PTS enzyme IIBC component" // "DNA-binding transcriptional repressor Mlc"
"MntR-Mn<sup>2+</sup> DNA-binding transcriptional dual regulator"	"mntR"	"DNA-binding transcriptional dual regulator MntR"
"MoaB protein"	"moaB"	"MoaB protein"
"moderate conductance mechanosensitive channel"	"ybiO"	"moderate conductance mechanosensitive channel"
"molybdate ABC transporter"	"modC" // "modB" // "modA"	"molybdate ABC transporter ATP binding subunit" // "molybdate ABC transporter membrane subunit" // "molybdate ABC transporter periplasmic binding protein"
"molybdenum cofactor insertion chaperone for PaoABC"	"paoD"	"molybdenum cofactor insertion chaperone for PaoABC"
"molybdopterin adenylyltransferase"	"mog"	"molybdopterin adenylyltransferase"
"molybdopterin molybdotransferase"	"moeA"	"molybdopterin molybdotransferase"
"molybdopterin synthase"	"moaD" // "moaE"	"molybdopterin synthase sulfur carrier subunit" // "molybdopterin synthase catalytic subunit"
"molybdopterin-guanine dinucleotide biosynthesis adaptor protein"	"mobB"	"molybdopterin-guanine dinucleotide biosynthesis adaptor protein"
"molybdopterin-synthase adenylyltransferase"	"moeB"	"molybdopterin-synthase adenylyltransferase"
"monoacetylchitobiose-6-phosphate hydrolase"	"chbF"	"monoacetylchitobiose-6-phosphate hydrolase"
"MqsA-MqsR antitoxin/toxin complex"	"mqsA" // "mqsR"	"antitoxin of the MqsRA toxin-antitoxin system / DNA-binding transcriptional repressor MqsA" // "mRNA interferase / toxin of the MqsR-MqsA toxin-antitoxin system"
"MtlR-HPr"	"mtlR" // "ptsH"	"transcriptional repressor MtlR" // "phosphocarrier protein HPr"
"MukEF complex"	"mukE" // "mukF"	"chromosome partitioning protein MukE" // "chromosome partitioning protein MukF"
"multidrug ABC exporter"	"ybhS" // "ybhR" // "ybhF"	"multidrug ABC exporter membrane subunit YbhS" // "multidrug ABC exporter membrane subunit YbhR" // "multidrug ABC exporter ATP binding subunit"
"multidrug efflux pump AcrAB-TolC"	"acrA" // "tolC" // "acrB"	"multidrug efflux pump membrane fusion protein AcrA" // "outer membrane channel TolC" // "multidrug efflux pump RND permease AcrB"
"multidrug efflux pump AcrAD-TolC"	"acrD" // "acrA" // "tolC"	"multidrug efflux pump RND permease AcrD" // "multidrug efflux pump membrane fusion protein AcrA" // "outer membrane channel TolC"
"multidrug efflux pump AcrEF-TolC"	"acrE" // "acrF" // "tolC"	"multidrug efflux pump membrane fusion protein AcrE" // "multidrug efflux pump RND permease AcrF" // "outer membrane channel TolC"
"multidrug efflux pump EmrAB-TolC"	"emrA" // "emrB" // "tolC"	"multidrug efflux pump membrane fusion protein EmrA" // "multidrug efflux pump membrane subunit EmrB" // "outer membrane channel TolC"
"multidrug efflux pump EmrKY-TolC"	"emrK" // "emrY" // "tolC"	"multidrug efflux pump membrane fusion protein EmrK" // "multidrug efflux pump membrane subunit EmrY" // "outer membrane channel TolC"
"multidrug efflux pump MdtABC-TolC"	"tolC" // "mdtC" // "mdtB" // "mdtA"	"outer membrane channel TolC" // "multidrug efflux pump RND permease subunit MdtC" // "multidrug efflux pump RND permease subunit MdtB" // "multidrug efflux pump membrane fusion protein MdtA"
"multidrug efflux pump MdtEF-TolC"	"tolC" // "mdtE" // "mdtF"	"outer membrane channel TolC" // "multidrug efflux pump membrane fusion protein MdtE" // "multidrug efflux pump RND permease MdtF"
"multidrug/betaine/choline efflux transporter EmrE"	"emrE"	"multidrug/betaine/choline efflux transporter EmrE"
"multidrug/spermidine efflux pump"	"mdtJ" // "mdtI"	"multidrug/spermidine efflux pump membrane subunit MdtJ" // "multidrug/spermidine efflux pump membrane subunit MdtI"
"multifunctional acyl-CoA thioesterase I and protease I and lysophospholipase L1"	"tesA"	"multifunctional acyl-CoA thioesterase I and protease I and lysophospholipase L1"
"multifunctional nuclease Cas1"	"cas1"	"multifunctional nuclease Cas1"
"murein tripeptide ABC transporter"	"oppB" // "oppC" // "oppD" // "oppF" // "mppA"	"murein tripeptide ABC transporter / oligopeptide ABC transporter inner membrane subunit OppB" // "murein tripeptide ABC transporter / oligopeptide ABC transporter inner membrane subunit OppC" // "murein tripeptide ABC transporter / oligopeptide ABC transporter ATP binding subunit OppD" // "murein tripeptide ABC transporter / oligopeptide ABC transporter ATP binding subunit OppF" // "murein tripeptide ABC transporter periplasmic binding protein"
"murein tripeptide amidase A"	"mpaA"	"murein tripeptide amidase A"
"MutHLS complex, methyl-directed mismatch repair"	"mutL" // "mutS" // "mutH"	"DNA mismatch repair protein MutL" // "DNA mismatch repair protein MutS" // "DNA mismatch repair protein MutH"
"<I>N,N'</I>-diacetylchitobiose-specific PTS enzyme II"	"chbA" // "chbC" // "chbB"	"<i>N,N'</i>-diacetylchitobiose-specific PTS enzyme IIA component" // "<i>N,N'</i>-diacetylchitobiose-specific PTS enzyme IIC component" // "<I>N,N'</I>-diacetylchitobiose-specific PTS enzyme IIB component"
"<I>N</I>-acetyl-D-galactosamine specific PTS (cryptic)"	"agaV" // "agaW"	"<I>N</I>-acetyl-D-galactosamine specific PTS enzyme IIB component" // "<I>N</I>-acetyl-D-galactosamine specific PTS truncated enzyme IIC component"
"N-acetylglucosamine specific PTS enzyme IIABC component"	"nagE"	"N-acetylglucosamine specific PTS enzyme IIABC component"
"<i>N</i>-acetylglucosamine-6-phosphate deacetylase"	"nagA"	"<i>N</i>-acetylglucosamine-6-phosphate deacetylase"
"N-acetylglutamate synthase"	"argA"	"N-acetylglutamate synthase"
"<i>N</i>-acetylmuramic acid 6-phosphate etherase"	"murQ"	"<i>N</i>-acetylmuramic acid 6-phosphate etherase"
"N-acetylmuramic acid-specific PTS enzyme II"	"murP" // "crr"	"N-acetylmuramic acid-specific PTS enzyme IICB component / anhydro-N-acetylmuramic acid transporter" // "Enzyme IIA<sup>Glc</sup>"
"<i>N</i>-acetylneuraminate lyase"	"nanA"	"<i>N</i>-acetylneuraminate lyase"
"<i>N</i>-acetylneuraminate mutarotase"	"nanM"	"<i>N</i>-acetylneuraminate mutarotase"
"<i>N</i>-acetylornithine aminotransferase / <i>N</i>-succinyldiaminopimelate aminotransferase"	"argD"	"<i>N</i>-acetylornithine aminotransferase / <i>N</i>-succinyldiaminopimelate aminotransferase"
"<i>N</i>-succinylarginine dihydrolase"	"astB"	"<i>N</i>-succinylarginine dihydrolase"
"<i>N<sup>5</sup></i>-carboxyaminoimidazole ribonucleotide mutase"	"purE"	"<i>N<sup>5</sup></i>-carboxyaminoimidazole ribonucleotide mutase"
"N<sup>6</sup>-L-threonylcarbamoyladenine synthase"	"tsaE" // "tsaD" // "tsaB"	"N<sup>6</sup>-L-threonylcarbamoyladenine synthase, TsaE subunit" // "N<sup>6</sup>-L-threonylcarbamoyladenine synthase, TsaD subunit" // "N<sup>6</sup>-L-threonylcarbamoyladenine synthase, TsaB subunit"
"N<sup>6</sup>-L-threonylcarbamoyladenine synthase, TsaB-TsaD dimer subunit"	"tsaB" // "tsaD"	"N<sup>6</sup>-L-threonylcarbamoyladenine synthase, TsaB subunit" // "N<sup>6</sup>-L-threonylcarbamoyladenine synthase, TsaD subunit"
"Na<sup>+</sup>:H<sup>+</sup> antiporter NhaA"	"nhaA"	"Na<sup>+</sup>:H<sup>+</sup> antiporter NhaA"
"NAD kinase"	"nadK"	"NAD kinase"
"NAD synthetase, NH<sub>3</sub>-dependent"	"nadE"	"NAD synthetase, NH<sub>3</sub>-dependent"
"NAD(P)H nitroreductase NfsB"	"nfsB"	"NAD(P)H nitroreductase NfsB"
"NAD(P)H:quinone oxidoreductase"	"wrbA"	"NAD(P)H:quinone oxidoreductase"
"NAD<sup>+</sup>-dependent succinate semialdehyde dehydrogenase"	"sad"	"NAD<sup>+</sup>-dependent succinate semialdehyde dehydrogenase"
"NAD-dependent dihydropyrimidine dehydrogenase"	"preT" // "preA"	"NAD-dependent dihydropyrimidine dehydrogenase subunit PreT" // "NAD-dependent dihydropyrimidine dehydrogenase subunit PreA"
"NADH dehydrogenase (quinone)"	""	"NADH dehydrogenase (quinone)"
"NADH pyrophosphatase"	"nudC"	"NADH pyrophosphatase"
"NADH:quinone oxidoreductase I"	"nuoA" // "nuoH" // "nuoJ" // "nuoK" // "nuoL" // "nuoM" // "nuoN" // "nuoI" // "nuoG" // "nuoF" // "nuoE" // "nuoC" // "nuoB"	"NADH:quinone oxidoreductase subunit A" // "NADH:quinone oxidoreductase subunit H" // "NADH:quinone oxidoreductase subunit J" // "NADH:quinone oxidoreductase subunit K" // "NADH:quinone oxidoreductase subunit L" // "NADH:quinone oxidoreductase subunit M" // "NADH:quinone oxidoreductase subunit N" // "NADH:quinone oxidoreductase subunit I" // "NADH:quinone oxidoreductase subunit G" // "NADH:quinone oxidoreductase subunit F" // "NADH:quinone oxidoreductase subunit E" // "NADH:quinone oxidoreductase subunit CD" // "NADH:quinone oxidoreductase subunit B"
"NADH:quinone oxidoreductase I, peripheral arm"	"nuoB" // "nuoC" // "nuoE" // "nuoF" // "nuoG" // "nuoI"	"NADH:quinone oxidoreductase subunit B" // "NADH:quinone oxidoreductase subunit CD" // "NADH:quinone oxidoreductase subunit E" // "NADH:quinone oxidoreductase subunit F" // "NADH:quinone oxidoreductase subunit G" // "NADH:quinone oxidoreductase subunit I"
"NADP<sup>+</sup>-dependent succinate-semialdehyde dehydrogenase"	"gabD"	"NADP<sup>+</sup>-dependent succinate-semialdehyde dehydrogenase"
"NADPH-dependent aldehyde reductase YqhD"	"yqhD"	"NADPH-dependent aldehyde reductase YqhD"
"NADPH-dependent curcumin/dihydrocurcumin reductase"	"curA"	"NADPH-dependent curcumin/dihydrocurcumin reductase"
"NADPH-dependent FMN reductase"	"ssuE"	"NADPH-dependent FMN reductase"
"NADPH-dependent nitroreductase NfsA"	"nfsA"	"NADPH-dependent nitroreductase NfsA"
"NADPH:quinone oxidoreductase MdaB"	"mdaB"	"NADPH:quinone oxidoreductase MdaB"
"negative regulator of MalT activity/cystathionine &beta;-lyase"	"malY"	"negative regulator of MalT activity/cystathionine &beta;-lyase"
"negative regulator of the <i>pho</i> regulon"	"phoU"	"negative regulator of the <i>pho</i> regulon"
"Ni(2+) ABC transporter"	"nikD" // "nikE" // "nikB" // "nikC" // "nikA"	"Ni(2+) ABC transporter ATP binding subunit NikD" // "Ni(2+) ABC transporter ATP binding subunit NikE" // "Ni(2+) ABC transporter membrane subunit NikB" // "Ni(2+) ABC transporter membrane subunit NikC" // "Ni(2+) ABC transporter periplasmic binding protein"
"nicotinate-nucleotide&mdash;dimethylbenzimidazole phosphoribosyltransferase"	"cobT"	"nicotinate-nucleotide&mdash;dimethylbenzimidazole phosphoribosyltransferase"
"NikR-Ni DNA-binding transcriptional repressor"	"nikR"	"DNA-binding transcriptional repressor NikR"
"nitrate reductase A"	"narG" // "narH" // "narI"	"nitrate reductase A subunit &alpha;" // "nitrate reductase A subunit &beta;" // "nitrate reductase A subunit &gamma;"
"nitrate reductase Z"	"narY" // "narZ" // "narV"	"nitrate reductase Z subunit &beta;" // "nitrate reductase Z subunit &alpha;" // "nitrate reductase Z subunit &gamma;"
"nitrite reductase subunit NirD" // "nitrite reductase catalytic subunit NirB"	"nirD" // "nirB"	"nitrite reductase subunit NirD" // "nitrite reductase catalytic subunit NirB"
"nitrogen regulator GlnK"	"glnK"	"nitrogen regulator GlnK"
"nitrogen regulatory protein PII-1"	"glnB"	"nitrogen regulatory protein PII-1"
"NMN aminohydrolase"	"pncC"	"NMN aminohydrolase"
"nonspecific DNA-binding protein YbiB"	"ybiB"	"nonspecific DNA-binding protein YbiB"
"NtrC-phosphorylated monomer"	"glnG"	"DNA-binding transcriptional dual regulator NtrC"
"nucleoid occlusion factor SlmA"	"slmA"	"nucleoid occlusion factor SlmA"
"nucleoside diphosphate kinase"	"ndk"	"nucleoside diphosphate kinase"
"nucleoside triphosphate pyrophosphatase YhdE"	"yhdE"	"nucleoside triphosphate pyrophosphatase YhdE"
"nucleoside triphosphate pyrophosphohydrolase"	"mazG"	"nucleoside triphosphate pyrophosphohydrolase"
"nucleotide exchange factor GrpE"	"grpE"	"nucleotide exchange factor GrpE"
"NusB-S10 complex"	"rpsJ" // "nusB"	"30S ribosomal subunit protein S10" // "transcription antitermination protein NusB"
"<i>O</i>-acetyl-ADP-ribose deacetylase, regulator of RNase III activity"	"ymdB"	"<i>O</i>-acetyl-ADP-ribose deacetylase, regulator of RNase III activity"
"<i>O</i>-acetylserine sulfhydrylase A"	"cysK"	"<i>O</i>-acetylserine sulfhydrylase A"
"<i>o</i>-succinylbenzoate&mdash;CoA ligase"	"menE"	"<i>o</i>-succinylbenzoate&mdash;CoA ligase"
"<i>O</i>-succinylhomoserine(thiol)-lyase / <i>O</i>-succinylhomoserine lyase"	"metB"	"<i>O</i>-succinylhomoserine(thiol)-lyase / <i>O</i>-succinylhomoserine lyase"
"oligopeptide ABC transporter"	"oppC" // "oppD" // "oppF" // "oppB" // "oppA"	"murein tripeptide ABC transporter / oligopeptide ABC transporter inner membrane subunit OppC" // "murein tripeptide ABC transporter / oligopeptide ABC transporter ATP binding subunit OppD" // "murein tripeptide ABC transporter / oligopeptide ABC transporter ATP binding subunit OppF" // "murein tripeptide ABC transporter / oligopeptide ABC transporter inner membrane subunit OppB" // "oligopeptide ABC transporter periplasmic binding protein"
"oligoribonuclease"	"orn"	"oligoribonuclease"
"OmpR-Phosphorylated"	"ompR"	"DNA-binding transcriptional dual regulator OmpR"
"ornithine carbamoyltransferase ArgF"	"argF"	"ornithine carbamoyltransferase ArgF"
"ornithine carbamoyltransferase ArgI"	"argI"	"ornithine carbamoyltransferase ArgI"
"ornithine decarboxylase, biosynthetic"	"speC"	"ornithine decarboxylase, biosynthetic"
"ornithine decarboxylase, degradative"	"speF"	"ornithine decarboxylase, degradative"
"orotate phosphoribosyltransferase"	"pyrE"	"orotate phosphoribosyltransferase"
"orotidine-5'-phosphate decarboxylase"	"pyrF"	"orotidine-5'-phosphate decarboxylase"
"osmolyte:H<sup>+</sup> symporter ProP"	"proP"	"osmolyte:H<sup>+</sup> symporter ProP"
"osmotically inducible peroxiredoxin"	"osmC"	"osmotically inducible peroxiredoxin"
"outer membrane channel TolC"	"tolC"	"outer membrane channel TolC"
"outer membrane phospholipase A"	"pldA"	"outer membrane phospholipase A"
"outer membrane porin C"	"ompC"	"outer membrane porin C"
"outer membrane porin F"	"ompF"	"outer membrane porin F"
"outer membrane porin PhoE"	"phoE"	"outer membrane porin PhoE"
"Outer Membrane Protein Assembly Complex"	"bamE" // "bamC" // "bamD" // "bamA" // "bamB"	"outer membrane protein assembly factor BamE" // "outer membrane protein assembly factor BamC" // "outer membrane protein assembly factor BamD" // "outer membrane protein assembly factor BamA" // "outer membrane protein assembly factor BamB"
"oxalyl-CoA decarboxylase"	"oxc"	"oxalyl-CoA decarboxylase"
"oxygen-sensing c-di-GMP phosphodiesterase DosP"	"dosP"	"oxygen-sensing c-di-GMP phosphodiesterase DosP"
"<i>p</i>-aminobenzoyl-glutamate hydrolase"	"abgB" // "abgA"	"<i>p</i>-aminobenzoyl-glutamate hydrolase subunit B" // "<i>p</i>-aminobenzoyl-glutamate hydrolase subunit A"
"PaaF-PaaG hydratase-isomerase complex"	"paaG" // "paaF"	"putative ring 1,2-epoxyphenylacetyl-CoA isomerase (oxepin-CoA forming)" // "putative 2,3-dehydroadipyl-CoA hydratase"
"pantetheine-phosphate adenylyltransferase"	"coaD"	"pantetheine-phosphate adenylyltransferase"
"pantothenate kinase"	"coaA"	"pantothenate kinase"
"pantothenate synthetase"	"panC"	"pantothenate synthetase"
"<i>para</i>-aminobenzoate synthase multi-enzyme complex"	"pabA" // "pabB" // "pabC"	"aminodeoxychorismate synthase subunit 2" // "aminodeoxychorismate synthase subunit 1" // "aminodeoxychorismate lyase"
"PEP synthetase regulatory protein"	"ppsR"	"PEP synthetase regulatory protein"
"peptidase component of the HslVU protease"	"hslV"	"peptidase component of the HslVU protease"
"peptidase D"	"pepD"	"peptidase D"
"peptidase T"	"pepT"	"peptidase T"
"peptide antibiotic/peptide nucleic acid transporter"	"sbmA"	"peptide antibiotic/peptide nucleic acid transporter"
"peptidoglycan DD-endopeptidase/peptidoglycan LD-endopeptidase"	"mepA"	"peptidoglycan DD-endopeptidase/peptidoglycan LD-endopeptidase"
"peptidoglycan glycosyltransferase / peptidoglycan DD-transpeptidase - MrcA-LpoA complex"	"lpoA" // "mrcA"	"outer membrane lipoprotein - activator of MrcA activity" // "peptidoglycan glycosyltransferase / peptidoglycan DD-transpeptidase MrcA"
"peptidoglycan glycosyltransferase / peptidoglycan DD-transpeptidase - MrcB-LpoB complex"	"mrcB" // "lpoB"	"peptidoglycan glycosyltransferase / peptidoglycan DD-transpeptidase MrcB" // "outer membrane lipoprotein - activator of MrcB activity"
"peptidoglycan glycosyltransferase / peptidoglycan DD-transpeptidase MrcA"	"mrcA"	"peptidoglycan glycosyltransferase / peptidoglycan DD-transpeptidase MrcA"
"peptidoglycan glycosyltransferase / peptidoglycan DD-transpeptidase MrcB"	"mrcB"	"peptidoglycan glycosyltransferase / peptidoglycan DD-transpeptidase MrcB"
"peptidyl-lysine acetyltransferase"	"patZ"	"peptidyl-lysine acetyltransferase"
"periplasmic acid stress chaperone"	"hdeB"	"periplasmic acid stress chaperone"
"periplasmic chaperone Skp"	"skp"	"periplasmic chaperone Skp"
"periplasmic chaperone, inhibitor of vertebrate C-type lysozyme"	"ivy"	"periplasmic chaperone, inhibitor of vertebrate C-type lysozyme"
"periplasmic nitrate reductase"	"napB" // "napA"	"periplasmic nitrate reductase cytochrome c<SUB>550</SUB> protein" // "periplasmic nitrate reductase subunit NapA"
"periplasmic nitrite reductase NrfAB"	"nrfA" // "nrfB"	"cytochrome <i>c</i><sub>552</sub> nitrite reductase" // "periplasmic nitrite reductase penta-heme <i>c</i>-type cytochrome"
"periplasmic phosphoanhydride phosphatase/multiple inositol-polyphosphate phosphatase"	"appA"	"periplasmic phosphoanhydride phosphatase/multiple inositol-polyphosphate phosphatase"
"periplasmic protein CpxP"	"cpxP"	"periplasmic protein CpxP"
"periplasmic protein-L-methionine sulfoxide reducing system"	"msrQ" // "msrP"	"periplasmic protein-L-methionine sulfoxide reductase heme binding subunit" // "periplasmic protein-L-methionine sulfoxide reductase catalytic subunit"
"periplasmic serine endoprotease"	"degQ"	"periplasmic serine endoprotease"
"periplasmic serine endoprotease DegP"	"degP"	"periplasmic serine endoprotease DegP"
"PF08943 family protein CsiD"	"csiD"	"PF08943 family protein CsiD"
"PF10636 family protein YdiE"	"ydiE"	"PF10636 family protein YdiE"
"phenylacetaldehyde dehydrogenase"	"feaB"	"phenylacetaldehyde dehydrogenase"
"phenylacetyl-CoA 1,2-epoxidase"	"paaE" // "paaA" // "paaC" // "paaB"	"phenylacetyl-CoA 1,2-epoxidase, reductase subunit" // "phenylacetyl-CoA 1,2-epoxidase, monooxygenase subunit" // "phenylacetyl-CoA 1,2-epoxidase, structural subunit" // "phenylacetyl-CoA 1,2-epoxidase subunit B"
"phenylacetyl-CoA thioesterase"	"paaI"	"phenylacetyl-CoA thioesterase"
"phenylalanine&mdash;tRNA ligase"	"pheS" // "pheT"	"phenylalanine&mdash;tRNA ligase subunit &alpha;" // "phenylalanine&mdash;tRNA ligase subunit &beta;"
"phenylhydantoinase"	"hyuA"	"phenylhydantoinase"
"phosphate ABC transporter"	"pstB" // "pstA" // "pstC" // "pstS"	"phosphate ABC transporter ATP binding subunit" // "phosphate ABC transporter membrane subunit PstA" // "phosphate ABC transporter membrane subunit PstC" // "phosphate ABC transporter periplasmic binding protein"
"phosphate acetyltransferase"	"pta"	"phosphate acetyltransferase"
"phosphate acetyltransferase EutD"	"eutD"	"phosphate acetyltransferase EutD"
"phosphatidylserine decarboxylase, heterodimer"	"psd"	"phosphatidylserine decarboxylase proenzyme" // "phosphatidylserine decarboxylase proenzyme"
"phosphatidylserine decarboxylase, heterodimer"	"psd"	"phosphatidylserine decarboxylase proenzyme" // "phosphatidylserine decarboxylase proenzyme"
"phosphatidylserine synthase"	"pssA"	"phosphatidylserine synthase"
"phosphoadenosine phosphosulfate reductase"	"cysH"	"phosphoadenosine phosphosulfate reductase"
"phosphodiesterase YfcE"	"yfcE"	"phosphodiesterase YfcE"
"phosphoenolpyruvate carboxylase"	"ppc"	"phosphoenolpyruvate carboxylase"
"phosphoenolpyruvate synthetase"	"ppsA"	"phosphoenolpyruvate synthetase"
"phosphoglycerate dehydrogenase"	"serA"	"phosphoglycerate dehydrogenase"
"phosphoribosylaminoimidazole-succinocarboxamide synthase"	"purC"	"phosphoribosylaminoimidazole-succinocarboxamide synthase"
"phosphoribosylformylglycinamide cyclo-ligase"	"purM"	"phosphoribosylformylglycinamide cyclo-ligase"
"Phosphorylated DNA-binding transcriptional dula regulator CpxR"	"cpxR"	"DNA-binding transcriptional dual regulator CpxR"
"phosphoserine/phosphohydroxythreonine aminotransferase"	"serC"	"phosphoserine/phosphohydroxythreonine aminotransferase"
"poly-<i>N</i>-acetyl-D-glucosamine synthase"	"pgaD" // "pgaC"	"poly-<i>N</i>-acetyl-D-glucosamine synthase subunit PgaD" // "poly-<i>N</i>-acetyl-D-glucosamine synthase subunit PgaC"
"polynucleotide phosphorylase"	"pnp"	"polynucleotide phosphorylase"
"polyphosphate kinase"	"ppk"	"polyphosphate kinase"
"polysaccharide export complex"	"wza" // "wzc"	"outer membrane polysaccharide export protein Wza" // "protein-tyrosine kinase Wzc"
"porphobilinogen synthase"	"hemB"	"porphobilinogen synthase"
"predicted xanthine dehydrogenase"	"xdhD" // "ygfM"	"fused putative xanthine/hypoxanthine oxidase: molybdopterin-binding subunit and Fe-S binding subunit" // "putative oxidoreductase"
"primosomal protein DnaT"	"dnaT"	"primosomal protein DnaT"
"primosomal replication protein N"	"priB"	"primosomal replication protein N"
"primosome"	"dnaB" // "dnaT" // "priB" // "priA" // "priC" // "dnaG"	"replicative DNA helicase" // "primosomal protein DnaT" // "primosomal replication protein N" // "primosome factor N'" // "primosomal replication protein N''" // "DNA primase"
"proline aminopeptidase P II"	"pepP"	"proline aminopeptidase P II"
"proline&mdash;tRNA ligase"	"proS"	"proline&mdash;tRNA ligase"
"proofreading thioesterase in enterobactin biosynthesis"	"entH"	"proofreading thioesterase in enterobactin biosynthesis"
"protease IV, a signal peptide peptidase"	"sppA"	"protease IV, a signal peptide peptidase"
"protein disulfide isomerase/protein disulfide oxidoreductase - DsbC<sub>reduced</sub>"	"dsbC"	"protein disulfide isomerase/protein disulfide oxidoreductase - DsbC<sub>reduced</sub>"
"protein HokC"	"hokC"	"protein HokC"
"protein translocation ATPase"	"secA"	"protein translocation ATPase"
"protein/nucleic acid deglycase 1"	"hchA"	"protein/nucleic acid deglycase 1"
"protein/nucleic acid deglycase 3"	"yajL"	"protein/nucleic acid deglycase 3"
"protoporphyrinogen oxidase"	"hemG"	"protoporphyrinogen oxidase"
"pseudouridine-5'-phosphate glycosidase"	"psuG"	"pseudouridine-5'-phosphate glycosidase"
"PTS enzyme I"	"ptsI"	"PTS enzyme I"
"purine nucleoside phosphoramidase"	"hinT"	"purine nucleoside phosphoramidase"
"purine nucleoside phosphorylase"	"deoD"	"purine nucleoside phosphorylase"
"putative 3-phenylpropionate/cinnamate dioxygenase"	"hcaC" // "hcaD" // "hcaF" // "hcaE"	"putative 3-phenylpropionate/cinnamate dioxygenase ferredoxin subunit" // "putative 3-phenylpropionate/cinnamate dioxygenase ferredoxin reductase subunit" // "putative 3-phenylpropionate/cinnamate dioxygenase subunit &beta;" // "putative 3-phenylpropionate/cinnamate dioxygenase subunit &alpha;"
"putative 4-oxalocrotonate tautomerase (4-OT)"	"pptA"	"putative 4-oxalocrotonate tautomerase (4-OT)"
"putative ABC transporter ArtPQMI"	"artI" // "artM" // "artQ" // "artP"	"putative ABC transporter periplasmic binding protein ArtI" // "L-arginine ABC transporter membrane subunit ArtM" // "L-arginine ABC transporter membrane subunit ArtQ" // "L-arginine ABC transporter ATP binding subunit"
"putative acyl-CoA dehydrogenase AidB"	"aidB"	"putative acyl-CoA dehydrogenase AidB"
"putative carbamoyltransferase"	"ygeW"	"putative carbamoyltransferase"
"putative carboxysome structural protein"	"eutN"	"putative carboxysome structural protein"
"putative D,D-dipeptide ABC transporter"	"ddpB" // "ddpC" // "ddpA" // "ddpD" // "ddpF"	"putative D,D-dipeptide ABC transporter membrane subunit DdpB" // "putative D,D-dipeptide ABC transporter membrane subunit DdpC" // "putative D,D-dipeptide ABC transporter periplasmic binding protein" // "putative D,D-dipeptide ABC transporter ATP-binding subunit DdpD" // "putative D,D-dipeptide ABC transporter ATP-binding subunit DdpF"
"putative enamine/imine deaminase"	"tdcF"	"putative enamine/imine deaminase"
"putative hydrolase"	"ycaC"	"putative hydrolase"
"putative menaquinol-cytochrome <i>c</i> reductase NrfCD"	"nrfD" // "nrfC"	"putative menaquinol-cytochrome <i>c</i> reductase subunit NrfD" // "putative menaquinol-cytochrome <i>c</i> reductase 4Fe-4S subunit"
"putative monooxygenase YdhR"	"ydhR"	"putative monooxygenase YdhR"
"putative multidrug efflux pump MdtNOP"	"mdtP" // "mdtO" // "mdtN"	"putative multidrug efflux pump outer membrane channel" // "putative multidrug efflux pump subunit MdtO" // "putative multidrug efflux pump membrane fusion protein"
"putative nucleoid-associated protein YbaB"	"ybaB"	"putative nucleoid-associated protein YbaB"
"putative oligopeptide ABC transporter ATP binding subunit" // "putative oligopeptide ABC transporter membrane subunit YejB" // "putative oligopeptide ABC transporter membrane subunit YejE" // "putative oligopeptide ABC transporter periplasmic binding protein"	"yejF" // "yejB" // "yejE" // "yejA"	"putative oligopeptide ABC transporter ATP binding subunit" // "putative oligopeptide ABC transporter membrane subunit YejB" // "putative oligopeptide ABC transporter membrane subunit YejE" // "putative oligopeptide ABC transporter periplasmic binding protein"
"putative oxidoreductase"	"ydjA"	"putative oxidoreductase"
"putative phosphatidylethanolamine synthesis regulator GnsA"	"gnsA"	"putative phosphatidylethanolamine synthesis regulator GnsA"
"putative PTS enzyme II FrvAB"	"frvB" // "frvA"	"putative PTS enzyme IIBC component FrvB" // "putative PTS enzyme IIA component FrvA"
"putative PTS enzyme II FrwCBDPtsA"	"frwC" // "frwB" // "frwD" // "ptsA"	"putative PTS enzyme IIC component FrwC" // "putative PTS enzyme IIB component FrwB" // "putative PTS enzyme IIB component FrwD" // "putative PTS multiphosphoryl transfer protein PtsA"
"putative PTS enzyme II FryBCA"	"fryC" // "fryB" // "fryA"	"putative PTS enzyme IIC component FryC" // "putative PTS enzyme IIB component FryB" // "putative PTS multiphosphoryl transfer protein FryA"
"putative PTS enzyme II SgcBCA"	"sgcB" // "sgcC" // "sgcA"	"putative PTS enzyme IIB component SgcB" // "putative PTS enzyme IIC component SgcC" // "putative PTS enzyme IIA component SgcA"
"putative quinol monooxygenase YgiN"	"ygiN"	"putative quinol monooxygenase YgiN"
"putative quinone oxidoreductase 1"	"qorA"	"putative quinone oxidoreductase 1"
"putative rRNA methyltransferase"	"yjtD"	"putative rRNA methyltransferase"
"putative structural protein, ethanolamine utilization microcompartment"	"eutS"	"putative structural protein, ethanolamine utilization microcompartment"
"putative structural protein, ethanolamine utilization microcompartment"	"eutL"	"putative structural protein, ethanolamine utilization microcompartment"
"putative structural protein, ethanolamine utilization microcompartment"	"eutM"	"putative structural protein, ethanolamine utilization microcompartment"
"putative transport complex, ABC superfamily"	"yadG" // "yadH"	"putative ABC transporter ATP-binding protein YadG" // "putative ABC transporter membrane subunit YadH"
"putative transport complex, ABC superfamily"	"ynjC" // "ynjD" // "ynjB"	"putative ABC transporter membrane subunit YnjC" // "putative ABC transporter ATP-binding protein YnjD" // "putative ABC transporter periplasmic binding protein YnjB"
"putative transport complex, ABC superfamily"	"ybbP" // "ybbA"	"putative ABC transporter membrane subunit YbbP" // "putative ABC transporter ATP-binding protein YbbA"
"putative transport complex, ABC superfamily"	"yphD" // "yphF" // "yphE"	"putative ABC transporter membrane subunit YphD" // "putative ABC transporter periplasmic binding protein YphF" // "putative ABC transporter ATP-binding protein YphE"
"putative transport complex, ABC superfamily"	"yhdZ" // "yhdY" // "yhdX" // "yhdW"	"putative ABC transporter ATP-binding subunit YhdZ" // "putative ABC transporter membrane subunit YhdY" // "putative ABC transporter membrane subunit YhdX" // "putative ABC transporter periplasmic binding protein YhdW"
"putative transport complex, ABC superfamily"	"ycjP" // "ycjO" // "ycjN" // "ycjV"	"putative ABC transporter membrane subunit YcjP" // "putative ABC transporter membrane subunit YcjO" // "putative ABC transporter periplasmic binding protein YcjN" // "putative ABC transporter ATP-binding protein YcjV"
"putative transport complex, ABC superfamily"	"ydcS" // "ydcT" // "ydcV" // "ydcU"	"putative ABC transporter periplasmic binding protein / polyhydroxybutyrate synthase" // "putative ABC transporter ATP-binding protein YdcT" // "putative ABC transporter membrane subunit YdcV" // "putative ABC transporter membrane subunit YdcU"
"putative xanthine dehydrogenase"	"xdhA" // "xdhB" // "xdhC"	"putative xanthine dehydrogenase molybdenum-binding subunit XdhA" // "putative xanthine dehydrogenase FAD-binding subunit XdhB" // "putative xanthine dehydrogenase iron-sulfur-binding subunit XdhC"
"putrescine ABC exporter"	"sapF" // "sapC" // "sapB" // "sapD"	"putrescine ABC exporter ATP binding protein SapF" // "putrescine ABC exporter membrane protein SapC" // "putrescine ABC exporter membrane subunit SapB" // "putrescine ABC exporter ATP binding protein SapD"
"putrescine ABC transporter"	"potG" // "potH" // "potI" // "potF"	"putrescine ABC transporter ATP binding subunit" // "putrescine ABC transporter membrane subunit PotH" // "putrescine ABC transporter membrane subunit PotI" // "putrescine ABC transporter periplasmic binding protein"
"putrescine aminotransferase"	"patA"	"putrescine aminotransferase"
"pyridine nucleotide transhydrogenase subunit &beta;" // "pyridine nucleotide transhydrogenase subunit &alpha;"	"pntB" // "pntA"	"pyridine nucleotide transhydrogenase subunit &beta;" // "pyridine nucleotide transhydrogenase subunit &alpha;"
"pyridoxal 5-phosphate synthase"	"pdxH"	"pyridoxal 5-phosphate synthase"
"pyridoxal kinase 2"	"pdxY"	"pyridoxal kinase 2"
"pyridoxal kinase I"	"pdxK"	"pyridoxal kinase I"
"pyridoxine 5'-phosphate synthase"	"pdxJ"	"pyridoxine 5'-phosphate synthase"
"pyrimidine-specific ribonucleoside hydrolase RihB"	"rihB"	"pyrimidine-specific ribonucleoside hydrolase RihB"
"pyrroline-5-carboxylate reductase"	"proC"	"pyrroline-5-carboxylate reductase"
"pyruvate dehydrogenase" // "pyruvate dehydrogenase, E2 subunit" // "lipoamide dehydrogenase"	"aceE" // "aceF" // "lpd"	"pyruvate dehydrogenase E1 component" // "pyruvate dehydrogenase, E2 subunit" // "lipoamide dehydrogenase"
"pyruvate dehydrogenase E1 component"	"aceE"	"pyruvate dehydrogenase E1 component"
"pyruvate formate-lyase"	"pflB"	"pyruvate formate-lyase"
"pyruvate kinase I"	"pykF"	"pyruvate kinase I"
"pyruvate kinase II"	"pykA"	"pyruvate kinase II"
"pyruvate oxidase"	"poxB"	"pyruvate oxidase"
"Qin prophage; antitoxin/DNA-binding transcriptional repressor RelB"	"relB"	"Qin prophage; antitoxin/DNA-binding transcriptional repressor RelB"
"quinolinate phosphoribosyltransferase (decarboxylating)"	"nadC"	"quinolinate phosphoribosyltransferase (decarboxylating)"
"quinolinate synthase"	"nadA"	"quinolinate synthase"
"radiation resistance protein YbgI"	"ybgI"	"radiation resistance protein YbgI"
"RcsAB DNA-binding transcriptional dual regulator"	"rcsB" // "rcsA"	"DNA-binding transcriptional activator RcsB" // "DNA-binding transcriptional activator RcsA"
"RcsB-BglJ DNA-binding transcriptional activator"	"bglJ" // "rcsB"	"DNA-binding transcriptional regulator BglJ" // "DNA-binding transcriptional activator RcsB"
"RcsB-P-phosphate"	""	""
"RecFOR complex"	"recF" // "recR" // "recO"	"DNA repair protein RecF" // "DNA repair protein RecR" // "DNA repair protein RecO"
"redox-responsive ATPase YchF"	"ychF"	"redox-responsive ATPase YchF"
"regulator of acid resistance, influenced by indole"	"ariR"	"regulator of acid resistance, influenced by indole"
"regulator of CsrB and CsrC decay"	"csrD"	"regulator of CsrB and CsrC decay"
"regulator of KefC-mediated potassium transport and quinone oxidoreductase"	"kefF"	"regulator of KefC-mediated potassium transport and quinone oxidoreductase"
"regulatory ATPase RavA"	"ravA"	"regulatory ATPase RavA"
"RelB-RelE antitoxin/toxin complex / DNA-binding transcriptional repressor"	"relB" // "relE"	"Qin prophage; antitoxin/DNA-binding transcriptional repressor RelB" // "Qin prophage; mRNA interferase toxin RelE"
"replicative DNA helicase"	"dnaB"	"replicative DNA helicase"
"resolvasome"	"ruvC" // "ruvB" // "ruvA"	"crossover junction endodeoxyribonuclease RuvC" // "Holliday junction branch migration complex subunit RuvB" // "Holliday junction branch migration complex subunit RuvA"
"rhamnulose-1-phosphate aldolase"	"rhaD"	"rhamnulose-1-phosphate aldolase"
"RhlB, ATP-dependent RNA helicase of the RNA degradosome"	"rhlB"	"RhlB, ATP-dependent RNA helicase of the RNA degradosome"
"riboflavin synthase"	"ribC"	"riboflavin synthase"
"ribokinase"	"rbsK"	"ribokinase"
"ribonuclease BN"	"rbn"	"ribonuclease BN"
"ribonuclease E"	"rne"	"ribonuclease E"
"ribonuclease E inhibitor protein A"	"rraA"	"ribonuclease E inhibitor protein A"
"ribonuclease E inhibitor protein B"	"rraB"	"ribonuclease E inhibitor protein B"
"ribonucleoside-diphosphate reductase 1"	"nrdA" // "nrdB"	"ribonucleoside-diphosphate reductase 1 subunit &alpha;" // "ribonucleoside-diphosphate reductase 1 subunit &beta;"
"ribonucleoside-diphosphate reductase 1 subunit &alpha;"	"nrdA"	"ribonucleoside-diphosphate reductase 1 subunit &alpha;"
"ribonucleoside-diphosphate reductase 1 subunit &beta;"	"nrdB"	"ribonucleoside-diphosphate reductase 1 subunit &beta;"
"ribonucleoside-diphosphate reductase 2"	"nrdE" // "nrdF"	"ribonucleoside-diphosphate reductase 2 subunit &alpha;" // "ribonucleoside-diphosphate reductase 2 subunit &beta;"
"ribonucleoside-diphosphate reductase 2 subunit &alpha;"	"nrdE"	"ribonucleoside-diphosphate reductase 2 subunit &alpha;"
"ribonucleoside-diphosphate reductase 2 subunit &beta;"	"nrdF"	"ribonucleoside-diphosphate reductase 2 subunit &beta;"
"ribose ABC transporter"	"rbsA" // "rbsC" // "rbsB"	"ribose ABC transporter ATP binding subunit" // "ribose ABC transporter membrane subunit" // "ribose ABC transporter periplasmic binding protein"
"ribose-5-phosphate isomerase A"	"rpiA"	"ribose-5-phosphate isomerase A"
"ribosomal protein S6 modification protein"	"rimK"	"ribosomal protein S6 modification protein"
"ribosomal protein-arginine oxygenase"	"roxA"	"ribosomal protein-arginine oxygenase"
"ribosome-dependent mRNA interferase toxin HigB"	"higB"	"ribosome-dependent mRNA interferase toxin HigB"
"ribulokinase"	"araB"	"ribulokinase"
"RNA polymerase sigma 19"	"rpoB" // "rpoC" // "rpoA" // "fecI"	"RNA polymerase subunit &beta;" // "RNA polymerase subunit &beta;'" // "RNA polymerase subunit &alpha;" // "RNA polymerase, sigma 19 factor"
"RNA polymerase sigma 24"	"rpoB" // "rpoC" // "rpoA" // "rpoE"	"RNA polymerase subunit &beta;" // "RNA polymerase subunit &beta;'" // "RNA polymerase subunit &alpha;" // "RNA polymerase sigma E factor"
"RNA polymerase sigma 28"	"fliA" // "rpoB" // "rpoC" // "rpoA"	"RNA polymerase, sigma 28 (sigma F) factor" // "RNA polymerase subunit &beta;" // "RNA polymerase subunit &beta;'" // "RNA polymerase subunit &alpha;"
"RNA polymerase sigma 32"	"rpoB" // "rpoC" // "rpoA" // "rpoH"	"RNA polymerase subunit &beta;" // "RNA polymerase subunit &beta;'" // "RNA polymerase subunit &alpha;" // "RNA polymerase, sigma 32 (sigma H) factor"
"RNA polymerase sigma 54"	"rpoB" // "rpoC" // "rpoA" // "rpoN"	"RNA polymerase subunit &beta;" // "RNA polymerase subunit &beta;'" // "RNA polymerase subunit &alpha;" // "RNA polymerase, sigma 54 (sigma N) factor"
"RNA polymerase sigma 70"	"rpoB" // "rpoC" // "rpoA" // "rpoD"	"RNA polymerase subunit &beta;" // "RNA polymerase subunit &beta;'" // "RNA polymerase subunit &alpha;" // "RNA polymerase, sigma 70 (sigma D) factor"
"RNA polymerase sigma S"	"rpoB" // "rpoC" // "rpoA" // "rpoS"	"RNA polymerase subunit &beta;" // "RNA polymerase subunit &beta;'" // "RNA polymerase subunit &alpha;" // "RNA polymerase, sigma S (sigma 38) factor"
"RNA polymerase, core enzyme"	"rpoA" // "rpoC" // "rpoB"	"RNA polymerase subunit &alpha;" // "RNA polymerase subunit &beta;'" // "RNA polymerase subunit &beta;"
"RNA-binding protein Hfq"	"hfq"	"RNA-binding protein Hfq"
"RNase adaptor protein"	"rapZ"	"RNase adaptor protein"
"RNase G"	"rng"	"RNase G"
"RNase III"	"rnc"	"RNase III"
"RNase T"	"rnt"	"RNase T"
"RnlA-RnlB toxin-antitoxin complex"	"rnlB" // "rnlA"	"CP4-57 prophage; antitoxin RnlB" // "CP4-57 prophage; RNase LS, toxin of the RnlAB toxin-antitoxin system"
"<i>S</i>-(hydroxymethyl)glutathione dehydrogenase"	"frmA"	"<i>S</i>-(hydroxymethyl)glutathione dehydrogenase"
"&alpha; cleavage product of SpeD" // "&beta; cleavage product of SpeD"	"speD"	"<i>S</i>-adenosylmethionine decarboxylase proenzyme" // "<i>S</i>-adenosylmethionine decarboxylase proenzyme"
"<i>S</i>-formylglutathione hydrolase / <i>S</i>-lactoylglutathione hydrolase"	"yeiG"	"<i>S</i>-formylglutathione hydrolase / <i>S</i>-lactoylglutathione hydrolase"
"S6:S18 ribosomal subunit complex"	"rpsR" // "rpsF"	"30S ribosomal subunit protein S18" // "30S ribosomal subunit protein S6"
"Sec Holo-Translocon"	"secD" // "secF" // "yajC" // "yidC" // "secY" // "secG" // "secE"	"Sec translocon accessory complex subunit SecD" // "Sec translocon accessory complex subunit SecF" // "Sec translocon accessory complex subunit YajC" // "membrane protein insertase YidC" // "Sec translocon subunit SecY" // "Sec translocon subunit SecG" // "Sec translocon subunit SecE"
"Sec translocon accessory complex"	"yidC" // "yajC" // "secF" // "secD"	"membrane protein insertase YidC" // "Sec translocon accessory complex subunit YajC" // "Sec translocon accessory complex subunit SecF" // "Sec translocon accessory complex subunit SecD"
"SecB chaperone"	"secB"	"SecB chaperone"
"SecYEG translocon"	"secE" // "secG" // "secY"	"Sec translocon subunit SecE" // "Sec translocon subunit SecG" // "Sec translocon subunit SecY"
"selenate reductase"	"ynfE" // "ynfF" // "ynfG" // "ynfH"	"putative selenate reductase YnfE" // "putative selenate reductase YnfF" // "putative oxidoreductase YnfG" // "putative menaquinol dehydrogenase"
"selenide, water dikinase"	"selD"	"selenide, water dikinase"
"selenocysteine synthase"	"selA"	"selenocysteine synthase"
"sensory histidine kinase ArcB"	"arcB"	"sensory histidine kinase ArcB"
"sensory histidine kinase AtoS"	"atoS"	"sensory histidine kinase AtoS"
"sensory histidine kinase CreC"	"creC"	"sensory histidine kinase CreC"
"sensory histidine kinase EnvZ"	"envZ"	"sensory histidine kinase EnvZ"
"sensory histidine kinase KdpD"	"kdpD"	"sensory histidine kinase KdpD"
"sensory histidine kinase NarQ"	"narQ"	"sensory histidine kinase NarQ"
"sensory histidine kinase NarX"	"narX"	"sensory histidine kinase NarX"
"sensory histidine kinase NtrB"	"glnL"	"sensory histidine kinase NtrB"
"sensory histidine kinase PhoQ"	"phoQ"	"sensory histidine kinase PhoQ"
"sensory histidine kinase PhoR"	"phoR"	"sensory histidine kinase PhoR"
"sensory histidine kinase TorS"	"torS"	"sensory histidine kinase TorS"
"serine acetyltransferase"	"cysE"	"serine acetyltransferase"
"serine endoprotease"	"degS"	"serine endoprotease"
"serine hydroxymethyltransferase"	"glyA"	"serine hydroxymethyltransferase"
"serine protease inhibitor ecotin"	"eco"	"serine protease inhibitor ecotin"
"serine&mdash;tRNA ligase"	"serS"	"serine&mdash;tRNA ligase"
"shikimate dehydrogenase / quinate dehydrogenase"	"ydiB"	"shikimate dehydrogenase / quinate dehydrogenase"
"siroheme synthase"	"cysG"	"siroheme synthase"
"small conductance mechanosensitive channel MscS"	"mscS"	"small conductance mechanosensitive channel MscS"
"small conductance mechanosensitive channel YnaI"	"ynaI"	"small conductance mechanosensitive channel YnaI"
"small heat shock protein IbpA"	"ibpA"	"small heat shock protein IbpA"
"small heat shock protein IbpB"	"ibpB"	"small heat shock protein IbpB"
"<i>sn</i>-glycerol 3-phosphate / glycerophosphodiester ABC transporter"	"ugpC" // "ugpA" // "ugpE" // "ugpB"	"<i>sn</i>-glycerol 3-phosphate ABC transporter ATP binding subunit" // "<i>sn</i>-glycerol 3-phosphate ABC transporter membrane subunit UgpA" // "<i>sn</i>-glycerol 3-phosphate ABC transporter membrane subunit UgpE" // "<i>sn</i>-glycerol 3-phosphate ABC transporter periplasmic binding protein"
"soluble pyridine nucleotide transhydrogenase"	"sthA"	"soluble pyridine nucleotide transhydrogenase"
"sorbitol-6-phosphate 2-dehydrogenase"	"srlD"	"sorbitol-6-phosphate 2-dehydrogenase"
"sorbitol-specific PTS enzyme II"	"srlA" // "srlB" // "srlE"	"sorbitol-specific PTS enzyme IIC<sub>2</sub> component" // "sorbitol-specific PTS enzyme IIA component" // "sorbitol-specific PTS enzyme IIBC<sub>1</sub> component"
"spermidine <i>N</i>-acetyltransferase"	"speG"	"spermidine <i>N</i>-acetyltransferase"
"spermidine preferential ABC transporter"	"potA" // "potB" // "potC" // "potD"	"spermidine preferential ABC transporter ATP binding subunit" // "spermidine preferential ABC transporter membrane subunit PotB" // "spermidine preferential ABC transporter membrane subunit PotC" // "spermidine preferential ABC transporter periplasmic binding protein"
"spermidine synthase"	"speE"	"spermidine synthase"
"ssDNA translocase and dsDNA helicase - DNA helicase II"	"uvrD"	"ssDNA translocase and dsDNA helicase - DNA helicase II"
"ssDNA-binding protein"	"ssb"	"ssDNA-binding protein"
"stationary phase nucleoid protein that sequesters iron and protects DNA from damage"	"dps"	"stationary phase nucleoid protein that sequesters iron and protects DNA from damage"
"subunit of E1(0) component of 2-oxoglutarate dehydrogenase"	"sucA"	"subunit of E1(0) component of 2-oxoglutarate dehydrogenase"
"succinate:quinone oxidoreductase subcomplex"	"sdhD" // "sdhC" // "sdhB" // "sdhA"	"succinate:quinone oxidoreductase, membrane protein SdhD" // "succinate:quinone oxidoreductase, membrane protein SdhC" // "succinate:quinone oxidoreductase, iron-sulfur cluster binding protein" // "succinate:quinone oxidoreductase, FAD binding protein"
"succinate:quinone oxidoreductase subcomplex"	"sdhA" // "sdhB" // "sdhC" // "sdhD"	"succinate:quinone oxidoreductase, FAD binding protein" // "succinate:quinone oxidoreductase, iron-sulfur cluster binding protein" // "succinate:quinone oxidoreductase, membrane protein SdhC" // "succinate:quinone oxidoreductase, membrane protein SdhD"
"succinyl-CoA synthetase subunit &alpha;" // "succinyl-CoA synthetase subunit &beta;"	"sucD" // "sucC"	"succinyl-CoA synthetase subunit &alpha;" // "succinyl-CoA synthetase subunit &beta;"
"succinyl-diaminopimelate desuccinylase"	"dapE"	"succinyl-diaminopimelate desuccinylase"
"succinylornithine transaminase"	"astC"	"succinylornithine transaminase"
"SufBC<sub>2</sub>D Fe-S cluster scaffold complex"	"sufB" // "sufC" // "sufD"	"Fe-S cluster scaffold complex subunit SufB" // "Fe-S cluster scaffold complex subunit SufC" // "Fe-S cluster scaffold complex subunit SufD"
"sulfate adenylyltransferase"	"cysD" // "cysN"	"sulfate adenylyltransferase subunit 2" // "sulfate adenylyltransferase subunit 1"
"sulfate/thiosulfate ABC transporter"	"sbp" // "cysW" // "cysU" // "cysA"	"sulfate/thiosulfate ABC transporter periplasmic binding protein Sbp" // "sulfate/thiosulfate ABC transporter inner membrane subunit CysW" // "sulfate/thiosulfate ABC transporter inner membrane subunit CysU" // "sulfate/thiosulfate ABC transporter ATP binding subunit"
"sulfite reductase, flavoprotein subunit"	"cysJ"	"sulfite reductase, flavoprotein subunit"
"sulfoquinovose isomerase"	"yihS"	"sulfoquinovose isomerase"
"sulfur acceptor for SufS cysteine desulfurase"	"sufE"	"sulfur acceptor for SufS cysteine desulfurase"
"sulfur acceptor protein CsdE"	"csdE"	"sulfur acceptor protein CsdE"
"sulfurtransferase complex TusBCD"	"tusB" // "tusC" // "tusD"	"sulfurtransferase complex subunit TusB" // "sulfurtransferase complex subunit TusC" // "sulfurtransferase complex subunit TusD"
"sulfurtransferase for molybdenum cofactor sulfuration"	"fdhD"	"sulfurtransferase for molybdenum cofactor sulfuration"
"superoxide dismutase (Fe)"	"sodB"	"superoxide dismutase (Fe)"
"superoxide dismutase (Mn)"	"sodA"	"superoxide dismutase (Mn)"
"tagatose-1,6-bisphosphate aldolase 1"	"kbaY" // "kbaZ"	"tagatose-1,6-bisphosphate aldolase 1 subunit KbaY" // "tagatose-1,6-bisphosphate aldolase 1 subunit KbaZ"
"tagatose-1,6-bisphosphate aldolase 2"	"gatY" // "gatZ"	"tagatose-1,6-bisphosphate aldolase 2 subunit GatY" // "tagatose-1,6-bisphosphate aldolase 2 subunit GatZ"
"tartronate semialdehyde reductase 2"	"glxR"	"tartronate semialdehyde reductase 2"
"taurine ABC transporter periplasmic binding protein" // "taurine ABC transporter membrane subunit" // "taurine ABC transporter ATP binding subunit"	"tauA" // "tauC" // "tauB"	"taurine ABC transporter periplasmic binding protein" // "taurine ABC transporter membrane subunit" // "taurine ABC transporter ATP binding subunit"
"taurine dioxygenase"	"tauD"	"taurine dioxygenase"
"tellurite methyltransferase"	"tehB"	"tellurite methyltransferase"
"tetrahydrodipicolinate succinylase"	"dapD"	"tetrahydrodipicolinate succinylase"
"The Tol-Pal Cell Envelope Complex"	"pal" // "tolA" // "tolB" // "tolR" // "tolQ"	"peptidoglycan-associated outer membrane lipoprotein Pal" // "Tol-Pal system protein TolA" // "Tol-Pal system periplasmic protein TolB" // "Tol-Pal system protein TolR" // "Tol-Pal system protein TolQ"
"thiamin ABC transporter ATP binding subunit" // "thiamin ABC transporter membrane subunit" // "thiamin ABC transporter periplasmic binding protein"	"thiQ" // "thiP" // "tbpA"	"thiamin ABC transporter ATP binding subunit" // "thiamin ABC transporter membrane subunit" // "thiamin ABC transporter periplasmic binding protein"
"thiazole synthase"	"thiG" // "thiH"	"1-deoxy-D-xylulose 5-phosphate:thiol sulfurtransferase" // "2-iminoacetate synthase"
"thioredoxin reductase"	"trxB"	"thioredoxin reductase"
"thiosulfate sulfurtransferase GlpE"	"glpE"	"thiosulfate sulfurtransferase GlpE"
"thiosulfate sulfurtransferase YgaP"	"ygaP"	"thiosulfate sulfurtransferase YgaP"
"thiosulfate/sulfate ABC transporter"	"cysA" // "cysW" // "cysU" // "cysP"	"sulfate/thiosulfate ABC transporter ATP binding subunit" // "sulfate/thiosulfate ABC transporter inner membrane subunit CysW" // "sulfate/thiosulfate ABC transporter inner membrane subunit CysU" // "thiosulfate/sulfate ABC transporter periplasmic binding protein CysP"
"threonine deaminase"	"ilvA"	"threonine deaminase"
"threonine dehydrogenase"	"tdh"	"threonine dehydrogenase"
"threonine&mdash;tRNA ligase"	"thrS"	"threonine&mdash;tRNA ligase"
"thymidine phosphorylase"	"deoA"	"thymidine phosphorylase"
"thymidylate synthase"	"thyA"	"thymidylate synthase"
"trans-2-enoyl-CoA reductase (NADPH)"	""	"trans-2-enoyl-CoA reductase (NADPH)"
"transaldolase B"	"talB"	"transaldolase B"
"transcription antiterminator and regulator of RNA stability"	"cspE"	"transcription antiterminator and regulator of RNA stability"
"transcription termination factor Rho"	"rho"	"transcription termination factor Rho"
"transcriptional antiterminator BglG"	"bglG"	"transcriptional antiterminator BglG"
"transketolase 1"	"tktA"	"transketolase 1"
"transketolase 2"	"tktB"	"transketolase 2"
"translocation and assembly module"	"tamB" // "tamA"	"translocation and assembly module subunit TamB" // "translocation and assembly module subunit TamA"
"trehalose-specific PTS enzyme II"	"treB" // "crr"	"trehalose-specific PTS enzyme IIBC component" // "Enzyme IIA<sup>Glc</sup>"
"triose-phosphate isomerase"	"tpiA"	"triose-phosphate isomerase"
"tRNA (cytidine/uridine-2'-<i>O</i>)-ribose methyltransferase"	"trmL"	"tRNA (cytidine/uridine-2'-<i>O</i>)-ribose methyltransferase"
"tRNA adenosine<sup>34</sup> deaminase"	"tadA"	"tRNA adenosine<sup>34</sup> deaminase"
"tRNA Cm32/Um32 methyltransferase"	"trmJ"	"tRNA Cm32/Um32 methyltransferase"
"tRNA cytosine<sup>32</sup> 2-sulfurtransferase TtcA"	"ttcA"	"tRNA cytosine<sup>32</sup> 2-sulfurtransferase TtcA"
"tRNA m<sup>1</sup>G37 methyltransferase"	"trmD"	"tRNA m<sup>1</sup>G37 methyltransferase"
"tRNA pseudouridine<sup>38-40</sup> synthase"	"truA"	"tRNA pseudouridine<sup>38-40</sup> synthase"
"tRNA threonylcarbamoyladenosine dehydratase"	"tcdA"	"tRNA threonylcarbamoyladenosine dehydratase"
"tRNA U34 carboxymethyltransferase"	"cmoB"	"tRNA U34 carboxymethyltransferase"
"tRNA-guanine transglycosylase"	"tgt"	"tRNA-guanine transglycosylase"
"truncated RNase PH"	"rph"	"truncated RNase PH"
"tryptophan synthase subunit &alpha;" // "tryptophan synthase, &beta; subunit dimer"	"trpA" // "trpB"	"tryptophan synthase subunit &alpha;" // "tryptophan synthase subunit &beta;"
"tryptophan synthase subunit &beta;"	"trpB"	"tryptophan synthase subunit &beta;"
"tryptophan&mdash;tRNA ligase"	"trpS"	"tryptophan&mdash;tRNA ligase"
"tryptophanase"	"tnaA"	"tryptophanase"
"twin arginine protein translocation system"	"tatB" // "tatC" // "tatE" // "tatA"	"twin arginine protein translocation system - TatB protein" // "twin arginine protein translocation system - TatC protein" // "twin arginine protein translocation system - TatE protein" // "twin arginine protein translocation system - TatA protein"
"type I fimbriae usher protein"	"fimD"	"type I fimbriae usher protein"
"Type II secretion system"	"gspC" // "gspD" // "gspE" // "gspF" // "gspG" // "gspH" // "gspI" // "gspJ" // "gspK" // "gspL" // "gspM" // "gspO"	"Type II secretion system protein GspC" // "Type II secretion system protein GspD" // "Type II secretion system protein GspE" // "Type II secretion system protein GspF" // "Type II secretion system protein GspG" // "Type II secretion system protein GspH" // "Type II secretion system protein GspI" // "Type II secretion system protein GspJ" // "Type II secretion system protein GspK" // "Type II secretion system protein GspL" // "Type II secretion system protein GspM" // "Type II secretion system prepilin peptidase"
"tyrosine aminotransferase"	"tyrB"	"tyrosine aminotransferase"
"tyrosine&mdash;tRNA ligase"	"tyrS"	"tyrosine&mdash;tRNA ligase"
"ubiquinol&mdash;[NapC cytochrome <i>c</i>] reductase NapGH"	"napG" // "napH"	"ferredoxin-type protein NapG" // "ferredoxin-type protein NapH"
"UDP-3-<i>O</i>-(3-hydroxymyristoyl)glucosamine <i>N</i>-acyltransferase"	"lpxD"	"UDP-3-<i>O</i>-(3-hydroxymyristoyl)glucosamine <i>N</i>-acyltransferase"
"UDP-glucose 4-epimerase"	"galE"	"UDP-glucose 4-epimerase"
"UDP-glucose 6-dehydrogenase"	"ugd"	"UDP-glucose 6-dehydrogenase"
"UDP-<i>N</i>-acetyl-D-mannosamine dehydrogenase"	"wecC"	"UDP-<i>N</i>-acetyl-D-mannosamine dehydrogenase"
"UDP-<i>N</i>-acetylglucosamine 2-epimerase"	"wecB"	"UDP-<i>N</i>-acetylglucosamine 2-epimerase"
"UDP-N-acetylglucosamine acyltransferase"	"lpxA"	"UDP-N-acetylglucosamine acyltransferase"
"UDP-<i>N</i>-acetylglucosamine&mdash;undecaprenyl-phosphate <i>N</i>-acetylglucosaminephosphotransferase"	"rfe"	"UDP-<i>N</i>-acetylglucosamine&mdash;undecaprenyl-phosphate <i>N</i>-acetylglucosaminephosphotransferase"
"UDP-<i>N</i>-acetylmuramate&mdash;L-alanine ligase"	"murC"	"UDP-<i>N</i>-acetylmuramate&mdash;L-alanine ligase"
"UhpA-Phosphorylated"	"uhpA"	"DNA-binding transcriptional activator UhpA"
"UMP kinase"	"pyrH"	"UMP kinase"
"undecaprenyl diphosphate synthase"	"ispU"	"undecaprenyl diphosphate synthase"
"undecaprenyl-phosphate-&alpha;-L-Ara4N flippase - ArnE subunit" // "undecaprenyl-phosphate-&alpha;-L-Ara4N flippase - ArnF subunit"	"arnE" // "arnF"	"undecaprenyl-phosphate-&alpha;-L-Ara4N flippase - ArnE subunit" // "undecaprenyl-phosphate-&alpha;-L-Ara4N flippase - ArnF subunit"
"universal stress protein G"	"uspG"	"universal stress protein G"
URAA-MONOMER	"uraA"	URAA-MONOMER
"uracil phosphoribosyltransferase"	"upp"	"uracil phosphoribosyltransferase"
"ureidoglycolate dehydrogenase"	"allD"	"ureidoglycolate dehydrogenase"
"uridine phosphorylase"	"udp"	"uridine phosphorylase"
"UTP&mdash;glucose-1-phosphate uridylyltransferase"	"galU"	"UTP&mdash;glucose-1-phosphate uridylyltransferase"
"vitamin B<sub>12</sub> ABC transporter"	"btuD" // "btuC" // "btuF"	"vitamin B<sub>12</sub> ABC transporter ATP binding subunit" // "vitamin B<sub>12</sub> ABC transporter membrane subunit" // "vitamin B<sub>12</sub> ABC transporter periplasmic binding protein"
"vitamin B12 outer membrane transport complex"	"btuB" // "exbD" // "exbB" // "tonB"	"cobalamin/cobinamide outer membrane transporter" // "Ton complex subunit ExbD" // "Ton complex subunit ExbB" // "Ton complex subunit TonB"
"water channel AqpZ"	"aqpZ"	"water channel AqpZ"
"Xaa-Pro dipeptidase"	"pepQ"	"Xaa-Pro dipeptidase"
"xanthine-guanine phsophoribosyltransferase"	"gpt"	"xanthine-guanine phsophoribosyltransferase"
"xanthosine phosphorylase"	"xapA"	"xanthosine phosphorylase"
"Xer site-specific recombination system"	"xerC" // "xerD"	"site-specific tyrosine recombinase" // "site-specific recombinase"
"xylose ABC transporter"	"xylG" // "xylH" // "xylF"	"xylose ABC transporter ATP binding subunit" // "xylose ABC transporter membrane subunit" // "xylose ABC transporter periplasmic binding protein"
"xylose isomerase"	"xylA"	"xylose isomerase"
"xylulokinase"	"xylB"	"xylulokinase"
"YefM antitoxin of the YoeB-YefM toxin-antitoxin pair and DNA binding transcriptional repressor"	"yefM"	"YefM antitoxin of the YoeB-YefM toxin-antitoxin pair and DNA binding transcriptional repressor"
"YefM-YoeB antitoxin/toxin complex / DNA-binding transcriptional repressor"	"yoeB" // "yefM"	"ribosome-dependent mRNA interferase toxin YoeB" // "YefM antitoxin of the YoeB-YefM toxin-antitoxin pair and DNA binding transcriptional repressor"
"YhaV-PrlF toxin-antitoxin complex"	"prlF" // "yhaV"	"antitoxin PrlF" // "ribosome-dependent mRNA interferase toxin YhaV"
"Z-ring inhibitor complex MinCD"	"minD" // "minC"	"Z-ring positioning protein MinD" // "Z-ring positioning protein MinC"
"Z-ring positioning protein MinC"	"minC"	"Z-ring positioning protein MinC"
"zinc responsive, periplasmic protein with chaperone activity"	"zraP"	"zinc responsive, periplasmic protein with chaperone activity"
"zinc-binding phosphatase"	"ycdX"	"zinc-binding phosphatase"
"Zn<sup>2+</sup> ABC transporter ATP binding subunit" // "Zn<sup>2+</sup> ABC transporter membrane subunit" // "Zn<sup>2+</sup> ABC transporter periplasmic binding protein"	"znuC" // "znuB" // "znuA"	"Zn<sup>2+</sup> ABC transporter ATP binding subunit" // "Zn<sup>2+</sup> ABC transporter membrane subunit" // "Zn<sup>2+</sup> ABC transporter periplasmic binding protein"
"Zn<sup>2+</sup>/Fe<sup>2+</sup>/Cd<sup>2+</sup> exporter"	"fieF"	"Zn<sup>2+</sup>/Fe<sup>2+</sup>/Cd<sup>2+</sup> exporter"
"ZntR-Zn<sup>2+</sup> DNA-binding transcriptional activator"	"zntR"	"DNA-binding transcriptional activator ZntR"
